#
# 倉頡五代構詞碼
#
# 碼表由惜緣兄製作
# 佛振修訂於 2012-04-08
#
# License: GPL
#
# 說明：
# 詞彙編碼中，單字的取碼有幾種情況：
# 取首碼、取尾碼、取首尾二碼、取首、次、尾三碼。
# 輔助字形中的單字，在詞彙中直接用倉頡字母而不拆開；
# 包含結構的單字，被包含部分的編碼位於'符號之後，可據此取得尾碼。
#
○	xxxxx
一	m
丁	mn
丂	mvs
七	p
万	ms
丈	jk
三	mmm
上	ym
下	my
丌	ml
不	mf
与	ysm
丏	mlvs
丐	myvs
丑	ng
丒	skm
专	qni
且	bm
丕	mfm
世	pt
丗	tj
丘	om
丙	mob
业	tc
丛	oom
东	kd
丝	vvm
丞	nem
丟	mgi
丠	lpm
両	mub
丢	hgi
丣	mlls
两	moob
严	mtch
並	ttc
丧	gcv
个	ol
丫	cl
丬	lim
中	l
丮	nq
丯	qj
丰	qj
丱	vlllm
串	ll
丳	llww
临	lloa
丵	tctj
丸	kni
丹	by
为	iks'i
主	yg
丼	tt'i
丽	mbib
丽	mmbib
举	fcq
乂	k
乃	nhs
久	no
乇	hp
么	hi
义	ik
之	ino
乌	pvsm
乍	os
乎	hfd
乏	hino
乐	hvd
乒	omh
乓	omi
乔	hkll
乕	hqb
乖	hjlp
乗	hjtd
乘	hdlp
乙	n
乜	ps
九	kn
乞	on
也	pd
习	sim
乡	vvh
乢	uu
乣	viu
乤	myn
乥	hcn
书	ids
乧	yjn
乨	iru
乩	yru
乪	nw
乫	krn
乬	ssn
乭	mrn
乮	hln
乯	hfdn
买	nyk
乱	hru
乲	ion
乲	mon
乳	bdu
乴	qln
乵	yju
乶	ibn
乷	ehn
乸	pdwy'i
乹	jju
乺	hln
乻	yyn
乼	egn
乽	jan
乾	jjon
乿	bfu
亀	nwlu
亁	jjon
亂	bbu
亃	fqu
亄	gtu
了	nn
予	ninn
争	nsd
亊	jfln
事	jlln
二	mm
亍	mmn
于	md
亏	mmvs
亐	mjs
云	mmi
互	mvnm
亓	mml
五	mdm
井	tt
亖	mmmm
亗	umm
亘	mam
亙	mbm
亚	mtc
些	ypmm
亜	mllm
亝	iiim
亞	mllm
亟	mem
亟	nem
亡	yv
亢	yhn
交	yck
亥	yvho
亦	ylnc
产	yth
亨	yrnn
亩	yw
亪	ycmo
享	yrnd
京	yrf
亭	yrbn
亮	yrbn
亮	yrbu
亯	yra
亰	yaf
亱	yoam
亲	ytd
亳	yrbp
亴	yrbn
亵	yqiv
亶	ywrm
亷	yhxc
亸	ydcwj
亹	yhbm
人	o
亽	oi
亾	vo
亿	on
什	oj
仁	omm
仂	oks
仃	omn
仄	mo
仅	oe
仆	oy
仇	okn
仈	oc
仉	ohn
今	oin
介	oll
仌	oo
仍	onhs
从	oo
仏	oi
仐	oj
仑	op
仒	oy
仓	osu
仔	ond
仕	og
他	opd
仗	ojk
付	odi
仙	ou
仚	ou
仛	ohp
仜	om
仝	om
仞	oshi
仟	ohj
仠	omj
仡	oon
仢	opi
代	oip
令	oini
以	vio
仦	of
仧	ymo
仨	ommm
仩	oym
仪	oik
仫	ohi
们	olis
仭	osk
仮	ohe
仯	ofh
仰	ohvl
仱	ooin
仲	ol
仳	opp
仴	ob
仵	ooj
件	ohq
价	ooll
仸	ohk
仹	oqj
仺	osm
仺	os'm
任	ohg
仼	omg
份	ocsh
仾	omvm
仿	oyhs
伀	oci
企	oylm
伂	ojb
伃	onin
伄	onl
伅	opu
伆	ophh
伇	ohne
伈	op
伉	oyhn
伊	osk
伋	onhe
伌	omsu
伍	omdm
伎	oje
伏	oik
伐	oi
休	od
伒	ohml
伓	omf
伔	obhu
伕	oqo
伖	oke
众	ooo
优	oiku
伙	of
会	ommi
伛	osk
伜	oknj
伝	ommi
伞	ofj
伟	oqs
传	oqni
伡	okq
伢	omvh
伣	obhu
伤	ooks
伥	opo
伦	oop
伧	oosu
伨	opmm
伩	oyk
伪	oiks
伫	ojm
伬	oso
伭	oyvi
伮	ove
伯	oha
估	ojr
伱	oof
伲	osp
伳	opt
伴	ofq
伵	ow'c
伶	ooii
伷	olw
伸	olwl
伹	obm
伺	osmr
伻	omfj
似	ovio
伽	oksr
伾	omfm
伿	orc
佀	orlr
佁	oir
佂	omym
佃	ow
佄	ot'm
佅	ojd
但	oam
佇	ojmn
佈	oklb
佉	ogi
佊	odhe
佋	oshr
佌	oymp
位	oyt
低	ohpm
低	ohvi
住	oyg
佐	okm
佑	okr
佒	olbk
体	odm
佔	oyr
何	omnr
佖	oph
佗	ojp
佘	ommf
余	omd
佚	ohqo
佛	olln
作	oos
佝	opr
佞	ommv
佟	ohey
你	onf
佡	oou
佢	oss
佣	ob'q
佤	omvn
佥	omfm
佦	omr
佧	oymy
佨	opru
佩	ohn'b
佪	ow'r
佫	oher
佬	ojkp
佭	oheq
佮	oomr
佯	otq
佰	oma
佱	ommm
佲	onir
佳	ogg
佴	osj
併	ott
佶	ogr
佷	oav
佸	ohjr
佹	onmu
佺	oomg
佻	olmo
佼	oyck
佽	ommo
佾	ocb
使	ojlk
侀	omtn
侁	ohgu
侂	oihp
侃	orhu
侄	omig
侅	oyvo
來	doo
侇	okn
侈	onin
侉	okms
侊	ofmu
例	omnn
侌	oini
侍	ogdi
侎	ofd
侏	ohjd
侐	ohbt
侑	okb
侒	ojv
侓	olq
侔	oihq
侕	omb'l
侖	omb't
侗	ob'mr
侘	ojhp
侙	oipm
侚	opa
供	otc
侜	ohby
依	oyhv
侞	ovr
侟	okld
侠	okt
価	omlw
侢	omgb
侣	orr
侤	ojks
侥	ojpu
侦	oybo
侧	obon
侨	ohkl
侩	oomi
侪	oykl
侫	oyvv
侬	ohbv
侭	osoy
侮	oowy
侯	onmk
侰	oskr
侱	orhg
侲	ommv
侳	ooog
侴	omnn
侵	osme
侶	orhr
侷	oss'r
侸	omrt
侹	onkg
侺	ouon
侻	ocru
侼	ojbd
侽	owks
侾	ojkd
便	omlk
俀	obv
俁	orvk
係	ohvf
促	oryo
俄	ohqi
俅	oije
俆	oomd
俇	okhg
俈	ohgr
俉	ommr
俊	oice
俋	orau
俌	oijb
俍	oiav
俎	oobm
俏	ofb
俐	ohdn
俑	onib
俒	ojmu
俓	omvm
俔	obuu
俕	ojd
俖	omfr
俗	ocor
俘	obnd
俙	okkb
俚	owg
俛	onau
俜	olws
保	ord
俞	ombn
俟	oiok
俠	okoo
信	oymr
俢	oheh
俣	ormk
俤	ocnh
俥	ojwj
俦	oqki
俧	ogp
俨	omth
俩	omob
俪	ombb
俫	odt
俬	ohdi
俭	oomm
修	olhh
修	oloh
俯	oioi
俰	ohdr
俱	obmc
俲	oyks
俳	olmy
俴	oii
俵	oqmv
俶	oyfe
俷	obau
俸	oqkq
俹	omlm
俺	oklu
俻	ohew
俼	oyib
俽	ohlo
俾	ohwj
俿	oypu
倀	osmv
倁	ookr
倂	oytt
倃	ohor
倄	okkb
倅	oyoj
倆	omlb
倇	ojnu
倈	odoo
倉	oiar
倊	ocip
個	ow'jr
倌	ojrr
倍	oytr
倎	otbc
倏	olhk
倏	olok
倐	olhf
們	oan
倒	omgn
倓	off
倔	osuu
倕	ohjm
倖	ogtj
倗	obb
倘	ofb'r
候	olnk
倚	okmr
倛	otmc
倜	ob'gr
倝	jjo
倞	oyrf
借	ota
倠	oog
倡	oaa
倢	ojlo
倣	oysk
値	ojbv
倥	ojcm
倦	ofqu
倧	ojmf
倨	osjr
倩	oqmb
倪	ohxu
倫	oomb
倬	oyaj
倭	ohdv
倮	owd
倯	odci
倰	ogce
倱	oapp
倲	odw
倳	ojln
倴	okjt
倵	ompm
倶	obuc
倷	okmf
倸	obd
倹	oomo
债	oqmo
倻	osjl
值	ojbm
倽	oomr
倾	opmo
倿	oytv
偀	otlk
偁	obgb
偂	otbn
偃	os'av
偄	ombk
偅	ohjg
偆	oqka
假	orse
偈	oapv
偉	odmq
偊	ohlb
偋	ostt
偌	otkr
偍	oamo
偎	owmv
偏	ohsb
偏	oisb
偐	oyhh
偑	ohn'i
偒	oamh
偓	osmg
偔	orrs
偕	oppa
偖	ojka
偗	ofhu
偘	orrr
偙	oybb
做	ojrk
偛	ohjx
停	oyrn
偝	olpb
偞	optd
偟	ohag
偠	omwv
偡	otmv
偢	ohdf
偣	oyta
偤	otcw
健	onkq
偦	onob
偧	oknn
偨	oypd
偩	onbc
偪	omrw
偫	ohoi
偬	opkp
偭	omw'l
偮	orsj
偯	oyrv
偰	oqhk
偱	ohju
偲	owp
偳	oumb
側	obcn
偵	oybc
偶	owlb
偷	oomn
偸	oomv
偹	olhw
偺	ohoa
偻	ofdv
偼	oyso
偽	oikf
偾	ojto
偿	ofbi
傀	ohui
傁	ohxe
傂	ohyu
傃	oqmf
傄	okcu
傅	oibi
傆	omhf
傇	otsj
傈	omwd
傉	omvi
傊	orbc
傋	ottb
傌	osqf
傍	oybs
傎	ojbc
傏	oilr
傐	oyrb
傑	onqd
傒	obvk
傓	ohsm
傔	otxc
傕	oobg
傖	ooir
傗	oyvw
傘	oooj
備	othb
傚	oykk
傛	ojcr
傜	obou
傝	oasm
傞	otqm
傟	ocim
傠	oyri
傡	oytt
傢	ojmo
傣	oqke
傤	ojiq
傥	ofbu
傦	obbb
傧	ojoc
储	oiva
傩	oeog
傪	oiih
傫	owvf
催	ouog
傭	oilb
傮	otwa
傯	ohwp
傰	oubb
傱	ohoo
傲	ogsk
傲	oqsk
傳	ojii
傴	os'rr
債	oqmc
傶	oihf
傷	ooah
傸	okkk
傹	oytu
傺	obof
傻	ohce
傼	otlo
傽	oytj
傾	opmc
傿	omyf
僀	okpb
僁	ohdp
僂	ollv
僃	otpb
僄	omwf
僅	otlm
僆	oyjj
僇	osmh
僈	oawe
僉	omro
僊	omwu
僋	ooic
僌	ojjk
働	ohgs
僎	oruc
像	onao
僐	otgr
僑	ohkb
僒	ojcr
僓	olmc
僔	otwi
僕	otco
僖	ogrr
僗	offs
僘	ofbk
僙	otlc
僚	okcf
僛	otco
僜	onot
僝	osnd
僞	obhf
僟	ovii
僠	ohdw
僡	ojip
僢	obbq
僣	oqoa
僤	orrj
僥	oggu
僦	oyfu
僧	ocwa
僨	ojtc
僩	oanb
僪	onhb
僫	ommp
僬	oogf
僭	omua
僮	oytg
僯	ofdq
僰	dbo
僱	ohsg
僲	omwq
僳	omwd
僴	oana
僵	omwm
僶	orxu
僷	otpd
僸	oddf
價	omwc
僺	orrd
僻	osrj
僼	otwt
僽	ohfp
僾	obbe
僿	ojtg
儀	otgi
儁	oogs
儂	otwv
儃	oywm
億	oytp
儅	ofbw
儆	otrk
儇	owlv
儈	ooma
儉	oomo
儊	oddo
儋	oncr
儌	ohsk
儍	ouce
儎	ojij
儏	oyed
儐	ojmc
儑	oavf
儒	ombb
儓	ogrg
儔	ogni
儕	oyx
儖	osmt
儗	opko
儘	olmt
儙	oylr
儚	otwn
儛	ootq
儜	ojpn
儝	offd
儞	omfb
償	ofbc
儠	ovvv
儡	owww
儢	oypp
儣	oitc
儤	oate
儥	ogwc
儦	oipf
儧	oqoc
儨	ohlc
儩	obch
優	ombe
儫	oyro
儬	oqbu
儭	oydu
儮	omhm
儯	ofqf
儰	otif
儱	oybp
儲	oyra
儳	onri
儴	oyrv
儵	olof
儶	ouob
儷	ommp
儸	owlg
儹	ohuc
儺	otog
儻	ofbf
儼	orrk
儽	owwf
儾	ojbv
儿	c
儿	lu
兀	mu
允	ihu
兂	kvu
元	mmu
兄	rhu
充	yihu
兆	lmuo
兇	ukhu
先	hghu
光	fmu
兊	cihu
克	jrhu
兌	crhu
免	nahu
兎	hlai
兏	hymu
児	lahu
兑	crhu
兒	hxhu
兓	mumvu
兔	nahi
兕	ssuu
兖	ycihu
兗	ycrhu
兘	muir
兙	juj
党	fbrhu
兛	juhj
兜	hvhu
兝	jucsh
兞	juhqu
兟	huhgu
兠	lmmu
兡	juma
兢	jujru
兣	jumwg
兤	fuitc
入	o
兦	vo
內	ob
全	omg
兩	mlb'o
兪	ombv
八	c
公	ci
六	yc
兮	cmvs
兯	csl
兰	tmm
共	tc
兲	mgc
关	tk
兴	fmc
兵	omc
其	tmmc
具	bmmc
典	tbc
兹	tvii
兺	cshp
养	toll
兼	txc
兽	cwmr
兾	cwtc
兿	tqii
冀	lpwtc
冁	cjstv
冂	ls
冃	b'mm
冄	bmm
内	ob
円	b'lm
冇	kb
冈	b'k
冉	gb
冊	bt
冋	b'r
册	bbm
再	mgb
冎	bnb
冏	b'cr
冐	ab
冑	lwb
冒	abu
冓	ttgb
冔	armd
冕	anau
冗	bhn
冘	lbu
写	bysm
冚	bu
军	bkq
农	hbv
冝	bbm
冞	bfd
冟	bhap
冠	bmui
冡	bmmo
冢	bmso
冣	bsje
冤	bnai
冥	bayc
冦	bmue
冧	bdd
冨	bmrw
冩	bhxf
冪	btab
冬	hey
冭	ky
冮	imm
冯	imnvm
冰	ime
冱	immvm
冲	iml
决	imdk
冴	immvh
况	imrhu
冶	imir
冷	imoii
冸	imfq
冹	imikk
冺	imrvp
冻	imkd
冼	imhgu
冽	immnn
冾	imomr
冿	imlq
净	imnsd
凁	imdl
凂	imnau
凃	imomd
凄	imjlv
凅	imw'jr
准	imog
凇	imdci
凈	imbsd
凉	imyrf
凊	imqmb
凋	imb'gr
凌	imgce
凍	imdw
凎	imc
减	imihr
凐	immwg
凑	imqkk
凒	imumt
凓	immwd
凔	imoir
凕	imbac
凖	igj
凗	imuog
凘	imtcl
凙	imwlj
凚	imddf
凛	imywf
凜	imywd
凝	impko
凞	imluf
凟	imgwc
几	hn
凡	hn'i
凢	hhn
凣	lhn
凤	hn'e
凥	shn
処	hehn
凧	hn'lb
凨	hn'mmi
凩	hn'd
凪	hn'ylm
凫	pysn
凬	hn'ma
凭	oghn
凮	hn'ma
凯	uuhn
凰	hn'hag
凱	uthn
凲	hn'txc
凳	nthn
凴	ifhn
凵	vl
凶	u'k
凷	u'g
凸	bss
凹	ssu
出	uu
击	qu
凼	u'e
函	u'ne
凾	u'nre
凿	tcu'j
刀	sh
刁	sm
刃	shi
刄	sk
刅	shc
分	csh
切	psh
刈	kln
刉	onln
刊	mjln
刋	hjln
刌	diln
刍	nsm
刍	ns'm
刎	phln
刏	onln
刐	byln
刑	mtln
划	iln
刓	muln
刔	dkln
刕	shshh
刖	bln
列	mnln
刘	ykln
则	boln
刚	bkln
创	ouln
刜	lnln
初	lsh
刞	bmln
刟	srln
删	bmln
刡	rpln
刢	oiln
刣	irln
判	fqln
別	rsln
刦	giln
刧	gish
刨	puln
利	hdln
刪	btln
别	rsln
刬	ijln
刭	nmln
刮	hrln
刯	mmln
到	mgln
刱	ttshi
刲	ggln
刳	ksln
刴	ndln
刵	sjln
制	hbln
刷	sbln
券	fqsh
刹	kdln
刺	dbln
刻	yoln
刼	gisk
刽	oiln
刾	ktln
刿	unln
剀	uuln
剁	hdln
剂	ylln
剃	chln
剄	mmln
剅	mtln
剆	iiln
則	bcln
剈	rbln
剉	ogln
削	fbln
剋	juln
剌	dlln
前	tbln
剎	kcln
剏	ttsk
剐	rbln
剑	omln
剒	taln
剓	hhsh
剔	ahln
剕	lmsyn
剖	yrln
剗	iiln
剘	tcln
剙	ttshi
剚	jnln
剛	buln
剜	juln
剝	veln
剞	krln
剟	eeeen
剠	yfln
剡	ffln
剢	moln
剣	ooln
剤	ylln
剥	neln
剦	kuln
剧	srln
剨	qrln
剩	hpln
剪	tbnh
剫	ieln
剬	ubln
剭	sgln
剮	bbln
副	mwln
剰	htln
剱	ooshi
割	jrln
剳	trln
剴	utln
創	orln
剶	voln
剷	ymln
剸	jiln
剹	shln
剺	jkmsh
剻	ubln
剼	ihln
剽	mfln
剾	srln
剿	vdln
劀	nbln
劁	ofln
劂	moln
劃	lmln
劄	hrln
劅	wiln
劆	icln
劇	yoln
劈	sjsh
劉	hcln
劊	oaln
劋	rdln
劌	yhln
劍	ooln
劎	oosh
劏	fwln
劐	teln
劑	yxln
劒	ooshi
劓	hlln
劔	oosk
劕	hcln
劖	niln
劗	hcln
劘	iyln
劙	viln
劚	siln
力	ks
劜	ksu
劝	eks
办	ksc
功	mks
加	ksr
务	heks
劢	msks
劣	fhks
劤	hlks
劥	ynks
劦	kskss
劧	qks
动	miks
助	bmks
努	veks
劫	giks
劬	prks
劭	srks
劮	hoks
劯	mrks
劰	haks
励	msks
劲	nmks
劳	tbks
労	fbks
劵	fqks
劶	hrks
劷	tqks
劸	ggks
効	ykks
劺	iqks
劻	sgks
劼	grks
劽	mnks
劾	yoks
势	qiks
勀	juks
勁	mmks
勂	hrks
勃	jdks
勄	oyks
勅	dlks
勆	ivks
勇	nbks
勈	nbks
勉	nuks
勊	juks
勋	roks
勌	fuks
勍	yfks
勎	ggks
勏	yrks
勐	ntks
勑	doks
勒	tjks
勓	paks
勔	mwks
動	hgks
勖	auks
勗	abms
勘	tvks
務	nhoks
勚	poks
勛	rcks
勜	cmks
勝	bfqs
勞	ffbks
募	taks
勠	shks
勡	mfks
勢	giks
勣	qcks
勤	tmks
勥	niks
勦	vdks
勧	ogks
勨	noks
勩	pcks
勪	hbks
勫	hwks
勬	ffks
勭	ygks
勮	yoks
勯	ymks
勰	kswp
勱	tbks
勲	hsf
勳	hfks
勴	ypks
勵	mbks
勶	hkks
勷	yvks
勸	tgks
勺	pi
勻	pmm
勼	pkn
勽	po
勾	pi
勿	phh
匀	pim
匁	pk
匂	pp
匃	pv'o
匄	pyv
包	pru
匆	pkk
匇	pn'i
匈	pu'k
匉	pmfj
匊	pfd
匋	poju
匌	pomr
匍	pijb
匎	pklu
匏	kspru
匐	pmrw
匑	phhn
匒	ptor
匓	phpe
匔	phhr
匕	p
化	op
北	lmp
匘	pvvw
匙	aop
匚	mv
匛	s'no
匜	s'pd
匝	s'lb
匞	s'm
匟	s'yhn
匠	s'hml
匡	s'mg
匢	s'phh
匣	s'wl
匤	s'mgi
匥	s'it
匦	s'kqn
匧	s'koo
匨	s'vmg
匩	s'umg
匪	s'lmy
匫	s'pha
匬	s'omn
匭	s'jjn
匮	s'lmo
匯	s'eog
匰	s'rrj
匱	s'lmc
匲	s'krr
匳	s'omo
匴	s'hbt
匵	s'gwc
匶	s'tox
匷	s'bug
匹	s'c
区	s'k
医	s'ok
匼	s'omr
匽	s'av
匾	s'hsb
匾	s'isb
匿	s'tkr
區	s'rrr
十	j
卂	nj
千	hj
卅	tj
卆	knj
升	ht
午	oj
卉	jt
半	fq
卋	jt
卌	tt
卍	nx
华	opj
协	jksc
卐	vx
卑	hwhj
卒	yooj
卓	yaj
協	jkss
单	cwj
卖	jnyk
南	jb'tj
単	fwj
卙	tvj
博	jibi
卛	vfj
卜	y
卞	yy
卟	ry
占	yr
卡	ymy
卢	ys
卣	yw's
卤	yw'k
卥	yw'kk
卦	ggy
卧	sly
卨	ybb'r
卫	slm
卬	hvsl
卭	msl
卮	hmsu
卯	hhsl
印	hpsl
危	nmsu
卲	srsl
即	aisl
却	gisl
卵	hhsl'i
卶	nnsl
卷	fqsu
卸	omsl
卹	htsl
卺	nemsu
卻	crsl
卼	munmu
卽	hpsl
卾	rssl
卿	hhail
厀	desl
厁	ojsl
厂	m
厄	msu
厅	mmn
历	mks
厇	mhp
厈	mmj
厉	mms
厊	mmvh
压	mgi
厌	mik
厍	mkq
厎	mhpm
厏	mos
厐	mikp
厑	mrp
厒	moju
厓	mgg
厔	mmig
厕	mbon
厖	miuh
厗	mytj
厘	mwg
厙	mjwj
厚	mand
厛	mrhl
厜	mhjm
厝	mta
厞	mlmy
原	mhaf
厠	mbcn
厡	mhae
厢	mdbu
厣	mikl
厤	mhdd
厥	mtuo
厦	mmue
厧	mjbc
厨	mmti
厩	maiu
厪	mtlm
厫	mgsk
厬	mahr
厭	mabk
厮	mtcl
厯	mddi
厰	mfbk
厱	momo
厲	mtwb
厳	fmmjk
厴	mkwl
厵	mfmff
厹	kni
厺	ki
去	gi
厼	if
厽	iii
厾	ngi
县	bmi
叀	jwi
叁	ikmmm
参	ikhhh
參	iiih
叄	iiim
叅	iiip
叆	mibbe
叇	miyle
又	e
叉	e'i
及	nhe
友	ke
双	ee
反	he
収	vle
叏	dje
叐	hke
发	ivke
叒	eee
叓	jle
叔	yfe
叕	eeee
取	sje
受	bbe
变	yce
叙	ode
叚	rsse
叛	fqhe
叜	jfe
叝	gisle
叞	sfe
叟	hxle
叠	eeem
叡	yue
叢	tcte
口	r
古	jr
句	pr
另	rks
叧	rsh
叨	rsh
叩	rsl
只	rc
叫	rvl
召	shr
叭	rc
叮	rmn
可	mnr
台	ir
叱	rp
史	lk
右	kr
叴	knr
叵	s'r
叶	rj
号	rmvs
司	smr
叹	re
叺	ro
叻	rks
叼	rsm
叽	rhn
叾	nnr
叿	rm
吀	rhj
吁	rmd
吂	yvr
吃	ron
各	her
吅	rr
吆	rvi
吇	rnd
合	omr
吉	gr
吊	rlb
吋	rdi
同	b'mr
名	nir
后	hmr
吏	jlk
吐	rg
向	hb'r
吒	rhp
吓	rmy
吔	rpd
吕	rr
吖	rcl
吗	rnvm
吘	roj
吙	rf
吚	rsk
君	skr
吜	rng
吝	ykr
吞	mkr
吟	roin
吠	rik
吡	rpp
吢	pr
吣	rp
吤	roll
吥	rmf
否	mfr
吧	rau
吨	rpu
吩	rcsh
吪	rop
含	oinr
听	rhml
吭	ryhn
吮	rihu
启	hsr
启	isr
吰	rki
吱	rje
吲	rnl
吳	rvnk
吴	rmk
吵	rfh
吶	rob
吷	rdk
吸	rnhe
吹	rno
吺	rhne
吻	rphh
吼	rndu
吽	rhq
吾	mmr
吿	hqr
呀	rmvh
呁	rpmm
呂	rhr
呃	rmsu
呄	nsjr
呅	ryk
呆	rd
呇	er
呈	rhg
呈	rmg
呉	rvnc
告	hgr
呋	rqo
呌	ryj
呍	rmmi
呎	rso
呏	rht
呐	rob
呑	hkr
呒	rmku
呓	rtn
呔	rki
呕	rs'k
呖	rmks
呗	rbo
员	rbo
呙	rob
呚	rok
呛	rosu
呜	rpvm
呝	rhsn
呞	rsmr
呟	ryvi
呠	rdm
呡	rrvp
呢	rsp
呣	rwy'i
呤	roii
呥	rgb
呦	rvis
呧	rhpm
周	b'gr
呩	rmmf
呪	rrhu
呫	ryr
呬	rw'c
呭	rpt
呮	rrc
呯	rmfj
呰	ypr
呱	rhvo
呲	rymp
味	rjd
呴	rpr
呵	rmnr
呶	rve
呷	rwl
呸	rmfm
呹	rhqo
呺	rrms
呻	rlwl
呼	rhfd
命	omrl
呾	ram
呿	rgi
咀	rbm
咁	rt'm
咂	rs'lb
咃	ropd
咄	ruu
咅	ytr
咆	rpru
咇	rph
咈	rlln
咉	rlbk
咊	rhd
咋	ros
和	hdr
咍	rir
咎	hor
咎	hyr
咏	rine
咐	rodi
咑	rqmn
咒	rrhn
咓	rmvn
咔	rymy
咕	rjr
咖	rksr
咗	rkm
咘	rklb
咙	rikp
咚	rhey
咛	rjmn
咜	rjp
咝	rvvm
咞	rmt
咟	rma
咠	rsj
咡	rsj
咢	rrmms
咣	rfmu
咤	rjhp
咥	rmig
咦	rkn
咧	rmnn
咨	ior
咨	mor
咩	rtq
咪	rfd
咫	sorc
咬	ryck
咭	rgr
咮	rhjd
咯	rher
咰	rpa
咱	rhbu
咲	rtk
咳	ryvo
咴	rkf
咵	rkms
咶	rhjr
咷	rlmo
咸	ihmr
咹	rjv
咺	rmam
咻	rod
咼	bb'r
咽	rw'k
咾	rjkp
咿	rosk
哀	yrhv
品	rrr
哂	rmcw
哃	rb'mr
哄	rtc
哅	rpu'k
哆	rnin
哇	rgg
哈	romr
哉	jir
哊	rkb
哋	rgpd
哌	rhhv
响	rhb'r
哎	rtk
哏	rav
哐	rs'mg
哑	rmtc
哒	ryk
哓	rjpu
哔	rppj
哕	run'i
哖	roq
哗	ropj
哘	rhon
哙	romi
哚	rhnd
哛	rpcsh
哜	rykl
哝	rhbv
哞	rihq
哟	rvmi
哠	rhgr
員	rbuc
哢	rmgt
哣	rmrt
哤	riuh
哥	mrnr
哦	rhqi
哧	rglc
哨	rfb
哩	rwg
哪	rsql
哫	rryo
哬	romr
哭	rrik
哮	rjkd
哯	rbuu
哰	rjhq
哱	rjbd
哲	qlr
哳	rqhl
哴	riav
哵	rrsn
哶	rtmj
哷	rbdi
哸	rbv
哹	rbnd
哺	rijb
哻	ramj
哼	ryrn
哽	rmlk
哾	rcru
哿	krmnr
唀	rhds
唁	rymr
唂	rcor
唃	rnb'g
唄	rbuc
唅	roir
唆	rice
唇	mvr
唈	rrau
唉	riok
唊	rkoo
唋	romd
唌	rnkm
唍	rjmu
唎	rhdn
唏	rkkb
唐	ilr
唑	roog
唒	rmcw
唓	rjwj
唔	rmmr
唕	rhaj
唖	rmlm
唗	rgyo
唘	mer
唙	rkhf
唚	rsme
唛	rqme
唜	djrp
唝	rmbo
唞	rqyj
唟	girp
唠	rtbs
唡	rmob
唢	rfbo
唣	rhap
唤	rnbk
唥	rimi
唦	refh
唧	rail
唨	rnlm
唩	rhdv
唪	rqkq
唫	rc
唬	rypn
唬	rypu
唭	rtmc
售	ogr
唯	rog
唰	rsbn
唱	raa
唲	rhxu
唳	rhsk
唳	risk
唴	rtgu
唵	rklu
唶	rta
唷	ryib
唸	roip
唹	rysy
唺	rtbc
唻	rdoo
唼	rytv
唽	rdhl
唾	rhjm
唿	rphp
啀	rmgg
啁	rb'gr
啂	rbdu
啃	rymb
啄	rmso
啅	ryaj
商	ycb'r
啇	ycb'r
啈	rgtj
啉	rdd
啊	rnlr
啋	rbd
啌	rjcm
啍	ryrd
啎	ojmmr
問	anr
啐	ryoj
啑	rjlo
啒	rsuu
啓	hkr
啔	hir
啕	rpou
啖	rff
啗	rnhx
啘	rjnu
啙	yprr
啚	ryw'r
啛	rjlv
啜	reee
啝	rhdr
啞	rmlm
啟	hrok
啠	hlr
啡	rlmy
啢	rmlb
啣	roml
啤	rhwj
啥	romr
啦	rqyt
啧	rqmo
啨	rqmb
啩	rggy
啪	rqha
啫	rjka
啬	gcw'r
啭	rkqi
啮	rymu
啯	rw'mi
啰	rwln
啱	rumr
啲	rhai
啳	rfqu
啴	rcwj
啵	rede
啶	rjmo
啷	riil
啸	rlll
啹	rsjr
啺	ramh
啻	ybr
啼	rybb
啽	rort
啾	rhdf
啿	rtmv
喀	rjhr
喁	rwlb
喂	rwmv
喃	rjb'j
善	tgtr
善	ttr
喅	rayt
喆	grgr
喇	rdln
喈	rppa
喉	ronk
喊	rihr
喋	rptd
喌	rrill
喍	rypd
喎	rbb'r
喏	rtkr
喐	rkbl
喑	ryta
喒	rhoa
喓	rmwv
喔	rsmg
喕	rmw'l
喖	rdjr
喗	rbjj
喘	rumb
喙	rvno
喚	rnbk
喛	rbme
喜	grtr
喝	rapv
喞	rhpl
喟	rwb
喠	rhjg
喡	rdmq
喢	rhjx
喣	rrf
喤	rhag
喥	rite
喦	rrru
喧	rjmm
喨	ryru
喩	romv
喪	grrv
喫	rqhk
喬	hkrb'r
喭	ryhh
單	rrwj
喯	rkjt
喰	roiv
喱	rmwg
喲	rvfi
喳	rdam
喴	rihv
喵	rtw
営	fbrhr
喷	rjto
喸	ibrp
喹	rkgg
喺	rohf
喻	romn
喼	rnsp
喽	rfdv
喾	fbhgr
喿	rrrd
嗀	grhne
嗁	rhyu
嗂	rbou
嗃	ryrb
嗄	rmue
嗅	rhuk
嗆	roir
嗇	gow'r
嗈	rvvu
嗉	rqmf
嗊	rmbc
嗋	rksb
嗌	rtct
嗍	rtub
嗎	rsqf
嗏	rtod
嗐	rjqr
嗑	rgit
嗒	rtor
嗓	reed
嗔	rjbc
嗕	rmvi
嗖	rhxe
嗗	rbbb
嗘	rbvk
嗙	rybs
嗚	rhrf
嗛	rtxc
嗜	rjpa
嗝	rmrb
嗞	rtvi
嗟	rtqm
嗠	bdher
嗡	rcim
嗢	rwot
嗣	rbsmr
嗤	rumi
嗥	rhaj
嗦	rjbf
嗧	kromb
嗨	reoy
嗩	rfbc
嗪	rqkd
嗫	rsje
嗬	rtor
嗭	jmrp
嗮	ramw
嗯	rwkp
嗰	row'r
嗱	rorq
嗲	rckn
嗳	rbbe
嗴	rtui
嗵	rynb
嗶	rwtj
嗷	rgsk
嗷	rqsk
嗸	gkr
嗹	ryjj
嗺	ruog
嗻	ritf
嗼	rtak
嗽	rdlo
嗾	rysk
嗿	roic
嘀	rycb
嘁	rihf
嘂	rrvlr
嘃	rilb
嘄	rhad
嘅	rhpu
嘆	rtlo
嘇	riih
嘈	rtwa
嘉	grtr
嘊	rumg
嘋	rjdk
嘌	rmwf
嘍	rllv
嘎	rmui
嘏	jrrse
嘐	rsmh
嘑	rypd
嘒	rqjm
嘓	rw'im
嘔	rs'rr
嘕	rmyf
嘖	rqmc
嘗	fbrpa
嘘	rypc
嘙	reev
嘚	rhoi
嘛	ridd
嘛	rijc
嘜	rjon
嘝	rnbj
嘞	rtjs
嘟	rjal
嘠	rmbi
嘡	rfbg
嘢	rwgn
嘣	rubb
嘤	rbov
嘥	rhoo
嘦	rcmwv
嘧	rjpu
嘨	rlll
嘩	rtmj
嘪	rwlc
嘫	rbkf
嘬	rase
嘭	rgth
嘮	rffs
嘯	rlx
嘰	rvii
嘱	rshb
嘲	rjjb
嘳	rlmc
嘴	rypb
嘵	rggu
嘶	rtcl
嘷	rhuj
嘸	rotf
嘹	rkcf
嘺	rhkb
嘻	rgrr
嘼	rrwmr
嘽	rrrj
嘾	rmwj
嘿	rwgf
噀	rruc
噁	rmmp
噂	rtwi
噃	rhdw
噄	rqhf
噅	rikf
噆	rmua
噇	rytg
噈	ryfu
噉	rmjk
噊	rnhb
噋	rydk
噌	rcwa
噍	rogf
噎	rgbt
噏	rorm
噐	rrmrr
噑	rhaj
噒	rfdq
噓	rypm
噔	rnot
噕	bhfr
噖	rmgn
噗	rtco
噘	rmto
噙	royb
噚	rsmi
噛	rymu
噜	rnwa
噝	rvff
噞	romo
噟	iogr
噠	rygq
噡	rncr
噢	rhbk
噣	rwli
噤	rddf
噥	rtwv
噦	rymh
噧	rtwb
器	rrikr
噩	mgrr
噪	rrrd
噫	rytp
噬	rhmo
噭	rhsk
噮	rwlv
噯	rbbe
噰	ryvg
噱	rypo
噲	roma
噳	rypk
噴	rjtc
噵	yur
噶	rtav
噷	ryao
噸	rpuc
噹	rfbw
噺	rydl
噻	rjtg
噼	rsrj
噽	grmfm
噾	rjca
噿	rsmj
嚀	rjpn
嚁	rsmg
嚂	rsit
嚃	rywe
嚄	rtoe
嚅	rmbb
嚆	rtyb
嚇	rgcc
嚈	rmak
嚉	rtgi
嚊	rhul
嚋	rgni
嚌	ryx
嚍	rlmt
嚎	ryro
嚏	rjbo
嚐	rfba
嚑	rhgf
嚒	rici
嚓	rjbf
嚔	rjbo
嚕	rnwa
嚖	rqjp
嚗	rate
嚘	rmbe
嚙	rymu
嚚	rrslr
嚛	rvid
嚜	rwgg
嚝	ritc
嚞	grgrr
嚟	rhhe
嚠	rhcn
嚡	rtjg
嚢	jcttv
嚣	rrmor
嚤	ridq
嚥	rtlf
嚦	rmhm
嚧	rypt
嚨	rybp
嚩	rvfi
嚪	ranx
嚫	rydu
嚬	ryhc
嚭	grmfr
嚮	vlhb'r
嚯	rmbg
嚰	ridr
嚱	ryti
嚲	ydrrj
嚳	hbhgr
嚴	rrmmk
嚵	rnri
嚶	rbcv
嚷	ryrv
嚸	rwfr
嚹	roud
嚺	rywo
嚻	rrmcr
嚼	rbwi
嚽	rgkc
嚾	rtrg
嚿	rtox
囀	rjji
囁	rsjj
囂	rrmcr
囃	rydg
囄	rybg
囅	rjstv
囆	rtwi
囇	rmmp
囈	rtgi
囉	rwlg
囊	jbrrv
囋	rhuc
囌	rtnd
囍	grgrr
囎	rbca
囏	togrr
囐	rybk
囑	rsei
囒	rtaw
囓	rqhu
囔	rjbv
囕	rswu
囖	rhwg
囗	w
囘	b'ru
囙	w's
囚	w'o
四	w'c
囜	w'i
囝	w'nd
回	w'r
囟	hw'k
因	w'k
囡	w'v
团	w'dh
団	w'di
囤	w'pu
囥	w'yhn
囦	w'e
囧	w'cb
囨	w'mf
囩	w'mmi
囪	hw'kk
囫	w'phh
囬	w'sl
园	w'mmu
囮	w'op
囯	w'mg
困	w'd
囱	hw'ni
囲	w'tt
図	w'yk
围	w'qs
囵	w'op
囶	w'cg
囷	w'hd
囸	w'mym
囹	w'oii
固	w'jr
囻	w'rvp
囼	w'ir
国	w'mgi
图	w'hey
囿	w'kb
圀	w'cys
圁	w'ymr
圂	w'mso
圃	w'ijb
圄	w'mmr
圅	niw'j
圆	w'rbo
圇	w'omb
圈	w'fqu
圉	w'gtj
圊	w'qmb
國	w'irm
圌	w'umb
圍	w'dmq
圎	w'ibc
圏	w'fqu
圐	w'wls
圑	w'ibi
園	w'grv
圓	w'rbc
圔	w'git
圕	w'lga
圖	w'ryw
圗	w'ijw
團	w'jii
圙	w'cmw
圚	w'lmc
圛	w'wlj
圜	w'wlv
圝	w'vff
圞	w'vfd
土	g
圠	gu
圡	gi
圢	gmn
圣	eg
圤	gy
圥	ghu
圦	go
圧	mg
在	klg
圩	gmd
圪	gon
圫	ghp
圬	gmms
圭	gg
圮	gsu
圯	gru
地	gpd
圱	hjg
圲	ghj
圳	glll
圴	gpi
圵	gym
圶	kg
圷	gmy
圸	gu
圹	gi
场	gnsh
圻	ghml
圼	ag
圽	gphh
圾	gnhe
圿	goll
址	gylm
坁	ghvp
坂	ghe
坃	gmmu
坄	ghne
坅	goin
坆	gok
均	gpim
均	gpmm
坈	gbhu
坉	gpu
坊	gyhs
坋	gcsh
坌	cshg
坍	gby
坎	gno
坏	gmf
坐	oog
坑	gyhn
坒	ppg
坓	ttg
坔	eg
坕	hog
坖	mmug
块	gdk
坘	gmvm
坙	mvvg
坚	leg
坛	gmmi
坜	gmks
坝	gbo
坞	gpvm
坟	gyk
坠	nog
坡	gdhe
坢	gfq
坣	fbg
坤	glwl
坥	gbm
坦	gam
坧	gmr
坨	gjp
坩	gt'm
坪	gmfj
坫	gyr
坬	ghvo
坭	gsp
坮	gir
坯	gmfm
坰	gb'r
坱	glbk
坲	glln
坳	gvis
坴	gcg
坵	gom
坶	gwy'i
坷	gmnr
坸	gpr
坹	gjc
坺	gike
坺	gikk
坻	ghpm
坻	ghvi
坼	ghmy
坽	goii
坾	gjmn
坿	godi
垀	ghfd
垁	gok
垂	hjtm
垃	gyt
垄	ipg
垅	gikp
垆	gys
垇	gssu
垈	opg
垉	gpru
垊	grvp
型	mng
垌	gb'mr
垍	ghbu
垎	gher
垏	glq
垐	mog
垑	gnin
垒	iiig
垓	gyvo
垔	mwg
垕	hrg
垖	ghrr
垗	glmo
垘	goik
垙	gfmu
垚	ggg
垛	ghnd
垜	gnsd
垝	gnmu
垞	gjhp
垟	gtq
垠	gav
垡	oig
垢	ghmr
垣	gmam
垤	gmig
垥	gomr
垦	avg
垧	ghb'r
垨	gjdi
垩	mcg
垪	gtt
垫	qig
垬	gtc
垭	gmtc
垮	gkms
垯	gyk
垰	gymy
垱	gfsm
垲	gusu
垳	ghon
垴	gyu'k
垵	gjv
垶	gytj
垷	gbuu
垸	gjmu
垹	gqjl
垺	gbnd
垻	gbuc
垼	heg
垽	elg
垾	gamj
垿	ginn
埀	hjlg
埁	guon
埂	gmlk
埃	giok
埄	ghej
埅	nsg
埆	gnb'g
埇	gnib
埈	gice
埉	gkoo
埊	ueg
埋	gwg
埌	giav
埍	grb
城	gihs
埏	gnkm
埏	gnkv
埐	gsme
埑	qlg
埒	gbdi
埓	gbdi
埔	gijb
埕	grhg
埕	grmg
埖	gtop
埗	gylh
埘	gadi
埙	grbo
埚	grob
埛	gb'cr
埜	ddg
埝	goip
埞	gjmo
域	girm
埠	ghrj
埡	gmlm
埢	gfqu
埣	gyoj
埤	ghwj
埥	gqmb
埦	gjnu
埧	gbmc
埨	gomb
埩	gbsd
埪	gjcm
埫	gfb'r
埬	gdw
埭	gle
埮	gff
埯	gklu
埰	gbd
埱	gyfe
埲	gqkq
埳	gnhx
埴	gjbm
埵	ghjm
埶	ggkni
執	gjkni
埸	gaph
培	gytr
基	tcg
埻	gyrd
埼	gkmr
埽	gsmb
埾	seg
埿	epg
堀	gsuu
堁	gwd
堂	fbrg
堃	ysg
堄	ghxu
堅	seg
堆	gog
堇	tlqm
堈	gb'tu
堉	gyib
堊	mmg
堋	gbb
堌	gw'jr
堍	gnai
堎	ggce
堏	dsg
堐	gmgg
堑	klg
堒	gapp
堓	gumj
堔	gbcd
堕	nbg
堖	gvvw
堗	gjck
堘	gfqg
堙	gmwg
堚	gbjj
堛	gmrw
堜	gdw'f
堝	gbb'r
堞	gptd
堟	gvno
堠	gonk
堡	odg
堢	gord
堣	gwlb
堤	gamo
堥	nkg
堦	gppa
堧	gmbk
堨	gapv
堩	gpmm
堪	gtmv
堫	guce
堬	gomn
堭	ghag
堮	grrs
堯	gggu
堰	gs'av
報	gjsle
堲	alg
堳	gahu
場	gamh
堵	gjka
堶	gkmb
堷	gyta
堸	ghn'i
堹	ghjg
堺	gwol
堻	eqg
堼	gig
堽	gwlm
堾	gqka
堿	gihr
塀	gstt
塁	wiog
塂	gtcu
塃	gtyu
塄	gwls
塅	ghje
塆	gycn
塇	gjmm
塈	aug
塉	gfcb
塊	ghui
塋	ffbg
塌	gasm
塍	bfqg
塎	gjcr
塏	gumt
塐	gqmf
塑	tbg
塒	gagi
塓	gbac
塔	gtor
塕	gcim
塖	ghdp
塗	edg
塘	gilr
塙	gyrb
塚	gbmo
塛	gmwd
塜	gbmo
塝	gybs
塞	jtcg
塟	tmpg
塠	gyhr
塡	gpbc
塢	ghrf
塣	egg
塤	grbc
塥	gmrb
塦	njg
塧	gtct
塨	gtcp
塩	gort
塪	gbhx
填	gjbc
塬	gmhf
塭	gwot
塮	ghhi
塯	ghhw
塰	eyg
塱	ibg
塲	goah
塳	gyhj
塴	gubb
塵	ipg
塶	gixp
塷	gyw'i
塸	gs'rr
塹	jlg
塺	icg
塻	gtak
塼	gjii
塽	gkkk
塾	yig
塿	gllv
墀	gseq
墁	gawe
墂	gmwf
境	gytu
墄	gihf
墅	wng
墆	gkpb
墇	gytj
墈	gtvs
墉	gilb
墊	gig
墋	giih
墌	gitf
墍	hug
墎	gydl
墏	vig
墐	gtlm
墑	gycb
墒	gycb
墓	takg
墔	guog
墕	gmyf
墖	gorw
増	gcwa
墘	gjjn
墙	ggcw
墚	gecd
墚	geid
墛	gsfi
墜	nog
墝	gggu
增	gcwa
墟	gypc
墟	gypm
墠	grrj
墡	gtgr
墢	gnoe
墣	gtco
墤	glmc
墥	gytg
墦	ghdw
墧	ghkb
墨	wgfg
墩	gydk
墪	ykg
墫	gtwi
墬	nog
墭	gist
墮	nbg
墯	pbg
墰	gmwj
墱	gnot
墲	gotf
墳	gjtc
墴	gtmc
墵	gmbi
墶	gygq
墷	gtmj
墸	gtja
墹	gana
墺	ghbk
墻	ggow
墼	jeg
墽	ghsk
墾	bvg
墿	gwlj
壀	gsrj
壁	sjg
壂	seg
壃	gmwm
壄	ddg
壅	yvgg
壆	hbg
壇	gywm
壈	gywd
壉	gypo
壊	gjwv
壋	gfbw
壌	gycv
壍	elg
壎	ghgf
壏	gsit
壐	mbg
壑	yeg
壒	gtgt
壓	mkg
壔	ggni
壕	gyro
壖	gmbb
壗	glmt
壘	wwwg
壙	gitc
壚	gypt
壛	ganx
壜	gami
壝	gylc
壞	gywv
壟	ypg
壠	gybp
壡	yueg
壢	gmhm
壣	gsjt
壤	gyrv
壥	gmwg
壦	gtrg
壧	grrk
壨	wwwwg
壩	gmbb
壪	gvfn
士	g
壬	hg
壭	gsl
壮	lmg
壯	vmg
声	gah
壱	gbp
売	gbhu
壳	gbhn
壴	grt
壵	ggg
壶	gbtc
壷	gblm
壸	gbmc
壹	gbmt
壺	gblm
壻	gnob
壼	gbmm
壽	gnmi
壾	gtss
壿	gtwi
夀	qmrdi
夁	gwlw
夃	ns'he
处	hey
夅	heq
夆	heqj
备	hew
夈	hefd
変	yche
夋	iche
夌	gche
复	oahe
夎	ooge
夏	muhe
夐	nbbue
夑	ffhe
夒	mche
夓	hche
夔	tche
夕	n'i
外	niy
夗	nisu
夘	nisl
夙	hn'mn'i
多	nin'i
夛	nmmn
夜	yonk
夝	nihqm
夞	nyrp
够	prnin
夠	nnpr
夡	nngr
夢	twln
夣	yiwn
夤	nijmc
夥	wdnin
夦	tvnin
大	k
夨	vk
天	mk
太	ki
夫	qo
夬	dk
夭	hk
央	lbk
夯	kks
夰	kll
失	hqo
夲	kj
夳	kmm
头	yk
夵	kf
夶	kk
夷	kn
夸	kmms
夹	kt
夺	kdi
夻	kr
夼	klll
夽	kmmi
夾	koo
夿	kau
奀	mfk
奁	ks'k
奂	nbk
奃	khpm
奄	klwu
奅	khhl
奆	kss
奇	kmnr
奈	kmmf
奉	qkq
奊	ggvk
奋	kw
奌	yrk
奍	fqll
奎	kgg
奏	qkhk
奏	qkmk
奐	nbk
契	qhk
奒	kyvo
奓	knin
奔	kjt
奕	yck
奖	lnk
套	ksmi
奘	vgk
奙	iklu
奚	bvik
奛	kab
奜	lyk
奝	kb'gr
奞	kog
奟	kbb
奠	twk
奡	mukll
奢	kjka
奣	mkab
奤	kmw'l
奥	hbk
奦	nsk
奧	hbk
奨	lik
奩	ks'rr
奪	kogi
奫	kell
奬	vik
奭	kmaa
奮	kogw
奯	kymh
奰	wlwwk
奱	vfk
奲	karrj
女	v
奴	ve
奵	vmn
奶	vnhs
奷	vhj
奸	vmj
她	vpd
奺	vno
奻	vv
奼	vhp
好	vnd
奾	vu
奿	kiv
妀	suv
妁	vpi
如	vr
妃	vsu
妄	yvv
妅	vm
妆	lmv
妇	vsm
妇	vs'm
妈	vnvm
妉	vlbu
妊	vhg
妋	vqo
妌	vtt
妍	vmt
妎	voll
妏	vyk
妐	vci
妑	vau
妒	vhs
妒	vis
妓	vje
妔	vyhn
妕	vl
妖	vhk
妗	voin
妘	vmmi
妙	vfh
妚	vmf
妛	umv
妜	vdk
妝	vmv
妞	vng
妟	av
妠	vob
妡	vhml
妢	vcsh
妣	vpp
妤	vnin
妥	bv
妦	vqj
妧	vmmu
妨	vyhs
妩	vmku
妪	vs'k
妫	viks
妬	vmr
妭	vikk
妮	vsp
妯	vlw
妰	vos
妱	vshr
妲	vam
妳	vnf
妴	nuv
妵	vyg
妶	vyvi
妷	vhqo
妸	vmnr
妹	vjd
妺	vdj
妻	jlv
妼	vph
妽	vlwl
妾	ytv
妿	krv
姀	vhd
姁	vpr
姂	vhio
姃	vmym
姄	vrvp
姅	vfq
姆	vwy'i
姇	oiv
姈	voii
姉	vylb
姊	vlxh
始	vir
姌	vgb
姍	vbt
姎	vlbk
姏	vt'm
姐	vbm
姑	vjr
姒	vvio
姓	vhqm
委	hdv
姕	ypv
姖	vss
姗	vbbm
姘	vtt
姙	vohg
姚	vlmo
姛	vb'mr
姜	tgv
姝	vhjd
姞	vgr
姟	vyvo
姠	vhb'r
姡	vhjr
姢	vib
姣	vyck
姤	vhmr
姥	vjkp
姦	vvv
姧	vvmj
姨	vkn
姩	voq
姪	vmig
姫	vs'll
姬	vs'll
姭	ksksv
姮	vmam
姯	vfmu
姰	vpa
姱	vkms
姲	vjv
姳	vnir
姴	mnv
姵	vhn'b
姶	vomr
姷	vkb
姸	vmjj
姹	vjhp
姺	vhgu
姻	vw'k
姼	vnin
姽	vnmu
姾	vomg
姿	iov
姿	mov
娀	vij
威	ihmv
娂	vtc
娃	vgg
娄	fdv
娅	vmtc
娆	vjpu
娇	vhkl
娈	ycv
娉	vlws
娊	vbuu
娋	vfb
娌	vwg
娍	vihs
娎	qlv
娏	viuh
娐	vbnd
娑	ehv
娒	vowy
娓	vshu
娔	vjru
娕	vdl
娖	vryo
娗	vnkg
娘	viav
娙	vmvm
娚	vwks
娛	vrvk
娜	vsql
娝	vmfr
娞	vbv
娟	vrb
娠	vmmv
娡	vgp
娢	voir
娣	vcnh
娤	vgv
娥	vhqi
娦	vomc
娧	vcru
娨	vamj
娩	vnau
娪	vmmr
娫	vnkm
娬	vmpm
娭	viok
娮	vymr
娯	vrvc
娰	vovo
娱	vrmk
娲	vrob
娳	vhdn
娴	vlsd
娵	vsje
娶	sev
娷	vhjm
娸	vtmc
娹	vnyi
娺	veee
娻	vdw
娼	vaa
娽	vnme
娽	vvne
娾	vmgg
娿	nrv
婀	vnlr
婁	llv
婂	vhab
婃	vjmf
婄	vytr
婅	vpfd
婆	eev
婇	vbd
婈	vgce
婉	vjnu
婊	vqmv
婋	vypu
婌	vyfe
婍	vkmr
婎	vog
婏	vnai
婐	vwd
婑	vhdv
婒	vff
婓	lyv
婔	vlmy
婕	vjlo
婖	vhkp
婖	vmkp
婗	vhxu
婘	vfqu
婙	vbsd
婚	vhpa
婛	vyrf
婜	sev
婝	vjmo
婞	vgtj
婟	vw'jr
婠	vjrr
婡	vdoo
婢	vhwj
婣	vlxl
婤	vb'gr
婥	vyaj
婦	vsmb
婧	vqmb
婨	vomb
婩	vumj
婪	ddv
婫	vapp
婬	vbhg
婭	vmlm
婮	vsjr
婯	mmbbv
婰	vtbc
婱	niv
婲	vtop
婳	vmu'w
婴	bov
婵	vcwj
婶	vjll
婷	vyrn
婸	vamh
婹	vmwv
婺	nkv
婻	vjb'j
婼	vtkr
婽	vrse
婾	vomv
婿	vnob
媀	vwlb
媁	vdmq
媂	vybb
媃	vnhd
媄	vtgk
媅	vtmv
媆	vmbk
媇	vytd
媈	vbjj
媉	vsmg
媊	vtbn
媋	vqka
媌	vtw
媍	vnbc
媎	vjka
媏	vumb
媐	suv
媑	vhjg
媒	vtmd
媓	vhag
媔	vmw'l
媕	vort
媖	vtlk
媗	vjmm
媘	vppa
媙	vihv
媚	vahu
媛	vbme
媜	vybc
媝	hfv
媞	vamo
媟	vptd
媠	vkmb
媡	vdw'f
媢	vabu
媣	vend
媤	vwp
媥	vhsb
媦	vwb
媧	vbb'r
媨	vtcw
媩	vjrb
媪	vabt
媫	vyso
媬	vord
媭	hov
媮	vomn
媯	vikf
媰	vpuu
媱	vbou
媲	vhwp
媳	vhup
媴	vgrv
媵	bfqv
媶	vtsj
媷	vmvi
媸	vumi
媹	vhhw
媺	vuuk
媻	hev
媼	vwot
媽	vsqf
媾	vttb
媿	vhui
嫀	vqkd
嫁	vjmo
嫂	vhxe
嫃	vjbc
嫄	vmhf
嫅	vtqm
嫆	vjcr
嫇	vbac
嫈	ffbv
嫉	vkok
嫊	vqmf
嫋	vnmm
嫌	vtxc
嫍	vbhx
嫎	vybs
嫏	viil
嫐	vwsv
嫑	mfmwv
嫒	vbbe
嫓	vhbp
嫔	vjoc
嫕	vskp
嫖	vmwf
嫗	vs'rr
嫘	vwvf
嫙	vyso
嫚	vawe
嫛	sev
嫜	vytj
嫝	vile
嫞	vilb
嫟	vs'tr
嫠	jkmv
嫡	vycb
嫢	quv
嫣	vmyf
嫤	vtlm
嫥	vjii
嫦	vfbb
嫧	vqmc
嫨	vtlo
嫩	vdlk
嫪	vsmh
嫫	vtak
嫬	vitf
嫭	vypd
嫮	vmbs
嫯	gkv
嫰	vdlo
嫱	vgcw
嫲	vidd
嫳	fkv
嫴	vjrj
嫵	votf
嫶	vogf
嫷	vnlb
嫸	vtgr
嫹	vtlc
嫺	vanb
嫻	vand
嫼	vwgf
嫽	vkcf
嫾	vfdq
嫿	vlgm
嬀	vbhf
嬁	vnot
嬂	vyia
嬃	hcv
嬄	vgbt
嬅	vtmj
嬆	vorm
嬇	vlmc
嬈	vggu
嬉	vgrr
嬊	tlpv
嬋	vrrj
嬌	vhkb
嬍	vugk
嬎	vnum
嬏	vhdw
嬐	vomo
嬑	vytp
嬒	voma
嬓	vhsk
嬔	vnum
嬕	vwlj
嬖	sjv
嬗	vywm
嬘	vyto
嬙	vgow
嬚	vitc
嬛	vwlv
嬜	yov
嬝	vhav
嬞	vthg
嬟	vtgi
嬠	vrrd
嬡	vbbe
嬢	vycv
嬣	vjpn
嬤	vici
嬥	vsmg
嬦	vgni
嬧	vlmt
嬨	vtvp
嬩	vhxc
嬪	vjmc
嬫	vffd
嬬	vmbb
嬭	vmfb
嬮	mkv
嬯	vgrg
嬰	bcv
嬱	elv
嬲	wsvws
嬳	vtoe
嬴	ynv
嬵	vvfb
嬶	vhul
嬷	vidi
嬸	vjhw
嬹	vhxc
嬺	vsrp
嬻	vgwc
嬼	vhcn
嬽	vwlk
嬾	vdlc
嬿	vtlf
孀	vmbu
孁	mbrrv
孂	vhat
孃	vyrv
孄	vanw
孅	voim
孆	vbcv
孇	voge
孈	vuob
孉	vtrg
孊	vicy
孋	vmmp
孌	vfv
孍	vrrk
孎	vsei
孏	vtaw
子	nd
孑	nnm
孓	nno
孔	ndu
孕	nsnd
孖	ndnd
字	jnd
存	klnd
孙	ndf
孚	bnd
孛	jbnd
孜	ndok
孝	jknd
孞	ndp
孟	ndbt
孠	srnd
孡	ndir
孢	ndpru
季	hdnd
孤	ndhvo
孥	vend
学	fbnd
孧	vsnd
孨	ndndd
孩	ndyvo
孪	ycnd
孫	ndhvf
孬	mfvnd
孭	ndbuc
孮	ndjmf
孯	send
孰	ydkni
孱	sndd
孲	ndmlm
孳	tvid
孴	ndnda
孵	hhsld
孶	yind
孷	jkmnd
學	hbnd
孹	sjnd
孺	ndmbb
孻	ndlmt
孼	ujnd
孽	thjd
孾	ndbcv
孿	vfnd
宁	jmn
宂	jhu
它	jp
宄	jkn
宅	jhp
宆	jn
宇	jmd
守	jdi
安	jv
宊	jik
宋	jd
完	jmmu
宍	jyc
宎	jhk
宏	jki
宐	jnim
宑	jtt
宒	jhqu
宓	jph
宔	jyg
宕	jmr
宖	jni
宗	jmmf
官	jrlr
宙	jlw
定	jmyo
宛	jeiu
宛	jniu
宜	jbm
宝	jmgi
实	jyk
実	jqk
宠	jikp
审	jlwl
客	jher
宣	jmam
室	jmig
宥	jkb
宦	js'll
宧	js'll
宨	jlmo
宩	jfd
宪	jhgu
宫	jrr
宬	jihs
宭	jskr
宮	jrhr
宯	jjkd
宰	jytj
宱	joos
宲	jrd
害	jqjr
害	jqmr
宴	jav
宵	jfb
家	jmso
宷	jhfd
宸	jmmv
容	jcor
宺	jrmu
宻	jecu
宼	jmuv
宽	jtbu
宾	jomc
宿	joma
寀	jbd
寁	jjlo
寂	jyfe
寃	jnai
寄	jkmr
寅	jmlc
密	jphu
寇	jmue
寈	jqmb
寉	jog
寊	jybc
寋	jtcu
富	jmrw
寍	jpbt
寎	jvmb
寏	jnbk
寐	jvmd
寑	jose
寒	jtcy
寓	jwlb
寔	jamo
寕	jmwn
寖	jese
寗	jphb
寘	jjbc
寙	jhoo
寚	jmgu
寛	jtbu
寜	jpbn
寝	jlme
寞	jtak
察	jbof
寠	jllv
寡	jmch
寢	jvme
寣	jvmr
寤	jvmr
寥	jsmh
實	jwjc
寧	jpbn
寨	jtcd
審	jhdw
寪	jikf
寫	jhxf
寬	jtbi
寭	jjip
寮	jkcf
寯	jogs
寰	jwlv
寱	jvmd
寲	jpko
寳	jmfc
寴	jydu
寵	jybp
寶	jmuc
寷	jujt
寸	di
对	edi
寺	gdi
寻	smdi
导	rudi
寽	bdi
対	ykdi
寿	qkdi
尀	srdi
封	ggdi
専	jwdi
尃	ibdi
射	hhdi
尅	judi
将	lmnii
將	vmbdi
專	jidi
尉	sfdi
尊	twdi
尋	smmri
尌	gtdi
對	tgdi
導	yudi
小	f
尐	fo
少	fh
尒	of
尓	of
尔	nf
尕	nsf
尖	fk
尗	ymf
尘	fg
尙	fb'r
尚	fb'r
尛	fff
尜	fkf
尝	fbmmi
尞	kcaf
尟	aofh
尠	tvfh
尡	fuapp
尢	ku
尣	chu
尤	iku
尥	kupi
尦	cupi
尧	jpmu
尨	iuhhh
尩	cumg
尪	kumg
尫	mumg
尬	kuoll
尭	jthu
尮	kunsd
尯	kunmu
尰	kuhjg
就	yfiku
尲	kutxc
尳	kubbb
尴	kulit
尵	kulmc
尶	musmt
尷	kusit
尸	s
尹	sk
尺	so
尻	skn
尼	sp
尽	soy
尾	shqu
尿	se
局	ss'r
屁	spp
层	smmi
屃	sbo
屄	sjc
居	sjr
屆	su'g
屇	sw
屈	suu
屉	spt
届	slw
屋	smig
屌	srlb
屍	smnp
屎	sfd
屏	stt
屐	shoe
屑	sfb
屒	smmv
屓	sbuc
屔	omsp
展	stv
屖	s'ytj
屗	sudi
屘	sund
屙	snlr
屚	smlb
屛	sytt
屜	shot
屝	slmy
属	shlb
屟	sptd
屠	sjka
屡	sfdv
屢	sllv
屣	shoo
層	scwa
履	shoe
屦	shov
屧	shod
屨	shov
屩	shob
屪	sjkf
屫	svmb
屬	sewi
屭	sbcc
屮	ul
屯	pu
屰	tu
山	u
屲	hu
屳	ou
屴	uks
屵	um
屶	ush
屷	unhs
屸	um
屹	uon
屺	usu
屻	ushi
屼	umu
屽	umj
屾	uu
屿	uysm
岀	uu
岁	uni
岂	usu
岃	ushi
岄	ub
岅	uhe
岆	uhk
岇	uhvl
岈	umvh
岉	uphh
岊	auu
岋	unhe
岌	unhe
岍	umt
岎	ucsh
岏	ummu
岐	uje
岑	uoin
岒	uoin
岓	uhml
岔	cshu
岕	uoll
岖	us'k
岗	ub'k
岘	ubhu
岙	hku
岚	uhn'k
岛	pysu
岜	uau
岝	uos
岞	uos
岟	ulbk
岠	uss
岡	b'tu
岢	umnr
岣	upr
岤	ujc
岥	udhe
岦	uyt
岧	ushr
岨	ubm
岩	umr
岪	ulln
岫	ulw
岬	uwl
岭	uoii
岮	ujp
岯	umfm
岰	uvis
岱	opu
岲	urhu
岳	omu
岴	uom
岵	ujr
岶	uha
岷	urvp
岸	ummj
岹	ushr
岺	uoii
岻	uhpm
岼	umfj
岽	ukd
岾	uyr
岿	ulls
峀	ulw
峁	uhhl
峂	uhey
峃	fbu
峄	ueq
峅	uit
峆	uomr
峇	uomr
峈	uher
峉	uher
峊	hru
峋	upa
峌	umig
峍	ulq
峎	uav
峏	umb'l
峐	uyvo
峑	uomg
峒	ub'mr
峓	ukn
峔	ujkp
峕	uya
峖	ujv
峗	unmu
峘	umam
峙	ugdi
峚	ukg
峛	umnn
峜	uoym
峝	ub'mr
峞	unmu
峟	ukb
峠	uymy
峡	ukt
峢	umnn
峣	ujpu
峤	uhkl
峥	unsd
峦	ycu
峧	uyck
峨	uhqi
峩	uhqi
峪	ucor
峫	umhl
峬	uijb
峭	ufb
峮	uskr
峯	uhej
峰	uhej
峱	khngu
峲	uhdn
峳	uolk
峴	ubuu
峵	ujki
島	hayu
峷	uytj
峸	uihs
峹	omdu
峺	umlk
峻	uice
峼	uhgr
峽	ukoo
峾	elu
峿	ummr
崀	uiav
崁	ugno
崂	utbs
崃	udt
崄	uomm
崅	unb'q
崆	ujcm
崇	ujmf
崈	jmmu
崉	uea
崊	udd
崋	umtj
崌	usjr
崍	udoo
崎	ukmr
崏	uhpa
崐	uapp
崑	uapp
崒	uyoj
崓	uw'jr
崔	uog
崕	umgg
崖	umgg
崗	ub'tu
崘	uomb
崙	uomb
崚	ugce
崛	usuu
崜	uhjm
崝	uqmb
崞	uyrd
崟	uc
崠	udw
崡	uu'ne
崢	ubsd
崣	uhdv
崤	ukkb
崥	uhwj
崦	uklu
崧	udci
崨	ujlo
崩	ubb
崪	uyoj
崫	usuu
崬	udw
崭	ukql
崮	uw'jr
崯	uc
崰	uvvw
崱	ubcn
崲	uhag
崳	uomn
崴	uihv
崵	uamh
崶	uggi
崷	utcw
崸	umbc
崹	uybb
崺	uysd
崻	uhoi
崼	uamo
崽	uwp
崾	umwv
崿	urrs
嵀	udyg
嵁	utmv
嵂	uhoq
嵃	uyhh
嵄	utgk
嵅	uihr
嵆	huu
嵇	hdiuu
嵈	ubme
嵉	uyrn
嵊	uhdp
嵋	uahu
嵌	utmo
嵍	nku
嵎	uwlb
嵏	uuce
嵐	uhn'i
嵑	uapv
嵒	rrru
嵓	urrr
嵔	uwmv
嵕	uuce
嵖	udam
嵗	uihh
嵘	utbd
嵙	uhdj
嵚	uopo
嵛	uomn
嵜	uytr
嵝	ufdv
嵞	omdu
嵟	umog
嵠	ubvk
嵡	ucim
嵢	uoir
嵣	uilr
嵤	ffbu
嵥	unqd
嵦	uumt
嵧	uhhw
嵨	uhrf
嵩	uyrb
嵪	uyrb
嵫	utvi
嵬	uhui
嵭	uybs
嵮	ujbc
嵯	utqm
嵰	utxc
嵱	ujcr
嵲	uhud
嵳	utqm
嵴	ufcb
嵵	uagi
嵶	unmm
嵷	uhoo
嵸	uhoo
嵹	unii
嵺	usmh
嵻	uile
嵼	uyhm
嵽	ukpb
嵾	uiih
嵿	umnc
嶀	umbs
嶁	ullv
嶂	uytj
嶃	ujjl
嶄	ujjl
嶅	gku
嶆	utwa
嶇	us'rr
嶈	uvmi
嶉	urog
嶊	uqog
嶋	uhaf
嶌	uhaf
嶍	usma
嶎	usfi
嶏	ummu
嶐	unlm
嶑	unao
嶒	ucwa
嶓	uhdw
嶔	ucno
嶕	uogf
嶖	uorm
嶗	uffs
嶘	udii
嶙	ufdq
嶚	ukcf
嶛	ukcf
嶜	umua
嶝	unot
嶞	nbu
嶟	utwi
嶠	uhkb
嶡	umto
嶢	uggu
嶣	uogf
嶤	uggu
嶥	umto
嶦	uncr
嶧	uwlj
嶨	hbu
嶩	utwv
嶪	utcd
嶫	utcd
嶬	utgi
嶭	uhrj
嶮	uomo
嶯	urji
嶰	unbq
嶱	utav
嶲	uogs
嶳	umog
嶴	hku
嶵	uwly
嶶	uhok
嶷	upko
嶸	uffd
嶹	ugni
嶺	uoic
嶻	ujig
嶼	uhxc
嶽	ukhk
嶾	ubmp
嶿	umbb
巀	ufgi
巁	umtb
巂	uogb
巃	uybp
巄	uybp
巅	ujco
巆	uffr
巇	uyti
巈	utjd
巉	unri
巊	ubcv
巋	uhmb
巌	ufmk
巍	uhvi
巎	umce
巏	utrg
巐	uybt
巑	uhuc
巒	vfu
巓	upcc
巔	ujcc
巕	uthv
巖	urrk
巗	urrk
巘	uybk
巙	utce
巚	uybk
川	lll
州	ilil
巟	yvhlu
巠	mvvm
巡	yvvv
巢	vvwd
巣	fwd
巤	vvwkv
工	m
左	km
巧	mmvs
巨	ss
巩	mhn'i
巪	ssn
巫	moo
巬	mnqo
巭	msqo
差	tqm
巯	nmyiu
巰	mmyiu
己	su
已	su
巳	ru
巴	au
巵	hmau
巶	srru
巷	tcru
巸	slru
巹	nemsu
巺	rumc
巻	fqsu
巼	aurp
巽	rutc
巾	lb
巿	jb
帀	mlb
币	hlb
市	ylb
布	klb
帄	lbmn
帅	lllb
帆	lbhn'i
帇	lb
师	llmb
帉	lbcsh
帊	lbau
帋	hplb
希	kklb
帍	hslb
帎	lblbu
帏	lbqs
帐	lbpo
帑	velb
帒	oplb
帓	lbdj
帔	lbdhe
帕	lbha
帖	lbyr
帗	lbikk
帘	jclb
帙	lbhqo
帚	smblb
帛	halb
帜	lbrc
帝	yblb
帞	lbma
帟	yclb
帠	hxlb
帡	lbtt
帢	lbomr
帣	fqlb
帤	vrlb
帥	hrlb
带	tjblb
帧	lbybo
帨	lbcru
帩	lbfb
帪	lbmmv
師	hrmlb
帬	srlb
席	itlb
帮	qllb
帯	tjblb
帰	llsmb
帱	lbqki
帲	lbytt
帳	lbsmv
帴	lbii
帵	lbjnu
帶	kpblb
帷	lbog
常	fbrlb
帹	lbytv
帺	lbtmc
帻	lbqmo
帼	lbw'mi
帽	lbabu
帾	lbjka
帿	lbonk
幀	lbybc
幁	lbmbc
幂	bakb
幃	lbdmq
幄	lbsmg
幅	lbmrw
幆	lbapv
幇	gilb
幈	lbstt
幉	lbptd
幊	lbmbc
幋	helb
幌	lbafu
幍	lbbhx
幎	lbbac
幏	lbjmo
幐	bfqb
幑	houbk
幒	lbhwp
幓	lbiih
幔	lbawe
幕	takb
幖	lbmwf
幗	lbw'im
幘	lbqmc
幙	lbtak
幚	qlhab
幛	lbytj
幜	lbayf
幝	lbrrj
幞	lbtco
幟	lbyia
幠	lbotf
幡	lbhdw
幢	lbytg
幣	fklb
幤	fklb
幥	lbfbq
幦	sjlb
幧	lbrrd
幨	lbncr
幩	lbjtc
幪	lbtbo
幫	gihab
幬	lbgni
幭	lbtwi
幮	lbigi
幯	lbhal
幰	lbjqp
幱	lbanw
干	mj
平	mfj
年	oq
幵	mjmj
并	tt
幷	tt
幸	gtj
幹	jjomj
幺	vi
幻	vis
幼	viks
幽	u'vii
幾	vihi
广	i
庀	ip
庁	imn
庂	io
広	ii
庄	ig
庅	ihi
庆	ik
庇	ipp
庈	ioin
庉	ipu
床	id
庋	ije
庌	imvh
庍	ihml
庎	ioll
序	inin
庐	iis
庑	imku
庒	igi
库	ikq
应	ifm
底	ihpm
底	ihvi
庖	ipru
店	iyr
庘	iwl
庙	ilw
庚	ilo
庛	iymp
府	iodi
庝	ihey
庞	iikp
废	iive
庠	itq
庡	iyhv
庢	imig
庣	ilmo
庤	igdi
庥	iod
度	ite
座	ioog
庨	ijkd
庩	iomd
庪	iqje
庫	ijwj
庬	iiuh
庭	inkg
庮	imcw
庯	iijb
庰	itt
庱	igce
庲	idoo
庳	ihwj
庴	ita
庵	iklu
庶	itf
康	ile
庸	ilb
庹	itso
庺	icid
庻	itoo
庼	ipmo
庽	iwlb
庾	ihxo
庿	itw
廀	ijfe
廁	ibcn
廂	idbu
廃	inop
廄	iaie
廅	igit
廆	ihui
廇	ihhw
廈	imue
廉	itxc
廊	iiil
廋	ihxe
廌	ixf
廍	iyrl
廎	ipmc
廏	ihpe
廐	ihpu
廑	itlm
廒	igsk
廒	iqsk
廓	iydl
廔	illv
廕	inli
廖	ismh
廗	ikpb
廘	iixp
廙	iwtc
廚	igti
廛	iwcg
廜	isja
廝	itcl
廞	icno
廟	ijjb
廠	ifbk
廡	iotf
廢	inoe
廣	itlc
廤	ijjp
廥	ioma
廦	isrj
廧	igow
廨	inbq
廩	iywd
廪	iywf
廫	ibsh
廬	iypt
廭	ihdc
廮	ibcv
廯	infq
廰	isjp
廱	ivug
廲	immp
廳	isgp
廵	nkvvv
延	nkhym
延	nkhyv
廷	nkhg
廸	nklw
廹	nkha
建	nklq
廻	nkw'r
廼	nkmcw
廽	nkw'sl
廾	jj
廿	t
开	mt
弁	it
异	rut
异	sut
弃	yit
弄	mgt
弅	csht
弆	git
弇	ort
弈	yct
弉	vgt
弊	fkt
弋	ip
弌	ipm
弍	ipmm
弎	ipmmm
式	ipm
弐	mpmm
弑	kdipm
弒	kcipm
弓	n
弔	nl
引	nl
弖	nm
弗	lln
弘	ni
弙	nmd
弚	cnl
弛	npd
弜	nn
弝	nau
弞	nno
弟	cnlh
张	npo
弡	nss
弢	nue
弣	nodi
弤	nhpm
弥	nnf
弦	nyvi
弧	nhvo
弨	nshr
弩	ven
弪	nnom
弫	ns'll
弬	ns'll
弭	nsj
弮	fqn
弯	ycn
弰	nfb
弱	nmnim
弲	nrb
弳	nmvm
弴	nyrd
張	nsmv
弶	nyrf
強	nili
弸	nbb
弹	ncwj
强	nrli
弻	nmwn
弼	nman
弽	nptd
弾	nfwj
弿	jtcn
彀	gnhne
彁	nmrr
彂	tcnok
彃	nwtj
彄	ns'rr
彅	ntbh
彆	fkn
彇	nlx
彈	nrrj
彉	ntlc
彊	nmwm
彋	nwlv
彌	nmfb
彍	nitc
彎	vfn
彏	nbue
彑	vnm
归	llsm
归	lls'm
当	fsm
当	fs'm
彔	vnme
录	nmme
彖	vnmo
彗	qjsm
彗	qjs'm
彘	vmpop
彙	vmbwd
彚	nmbwd
彛	smfht
彜	vmfht
彝	vmfft
彞	nmfft
彟	sitoe
彠	sitoe
形	mthhh
彣	ykhhh
彤	byhhh
彥	ykmhh
彦	yhhhh
彧	ikrm
彨	mbhhh
彩	bdhhh
彪	ynhhh
彪	yuhhh
彫	brhhh
彬	ddhh
彭	gthhh
彮	jrhhh
彯	mfhhh
彰	yjhhh
影	afhhh
彲	mphhh
彳	ho
彴	hopi
彵	hopd
彶	honhe
彷	hoyhs
彸	hoci
役	hohne
彺	homg
彻	hopsh
彼	hodhe
彽	hohpm
彾	hooii
彿	holln
往	hoyg
征	homym
徂	hobm
徃	hohqm
径	honom
待	hogdi
徆	homcw
徇	hopa
很	hoav
徉	hotq
徊	how'r
律	holq
後	hovie
徍	hogg
徎	hormg
徏	hoylh
徐	hoomd
徑	homvm
徒	hogyo
従	hotyo
徔	hotio
徕	hodt
徖	hojmf
得	hoami
徘	holmy
徙	hoylo
徚	hodw'f
徛	hokmr
徜	hofb'r
徝	hojbm
從	hoooo
徟	hob'gr
徠	hodoo
御	hooml
徢	hojlo
徣	hota
徤	honkq
徥	hoamo
徦	horse
徧	hohsb
徨	hohag
復	hooae
循	hohju
徫	hodmq
徬	hoybs
徭	hobou
微	hounk
微	houuk
徯	hobvk
徰	hommm
徱	homwf
徲	hoseq
徳	hojwp
徴	hougk
徵	hougk
徶	hofbk
德	hojwp
徸	hoytg
徹	hoybk
徺	hoggu
徻	hooma
徼	hohsk
徽	houfk
徾	hourk
徿	hoybp
忀	hoyrv
忁	hoaue
忂	hobug
心	p
必	ph
忆	pn
忇	pks
忈	mmp
忉	psh
忊	pmn
忋	psu
忌	sup
忍	sip
忎	hjp
忏	phj
忐	ymp
忑	myp
忒	ipp
忓	pmj
忔	pon
忕	pk
忖	pdi
志	gp
忘	yvp
忙	pyv
忚	ppd
忛	phn'i
応	ip
忝	hkp
忝	mkp
忞	ykp
忟	pyk
忠	lp
忡	pl
忢	mmp
忣	pnhe
忤	poj
忥	onp
忦	poll
忧	piku
忨	pmmu
忩	cip
忪	pci
快	pdk
忬	pnin
忭	pyy
忮	pje
忯	phvp
忰	pknj
忱	plbu
忲	pki
忳	ppu
忴	poin
念	oinp
忶	pmmi
忷	pu'k
忸	png
忹	phg
忺	pno
忻	phml
忼	pyhn
忽	php
忾	pomn
忿	cshp
怀	pmf
态	kip
怂	oop
怃	pmku
怄	ps'k
怅	ppo
怆	posu
怇	pss
怈	ppt
怉	ppru
怊	pshr
怋	prvp
怌	pmfm
怍	pos
怎	osp
怏	plbk
怐	ppr
怑	pfq
怒	vep
怓	pve
怔	pmym
怕	pha
怖	pklb
怗	pyr
怘	jrp
怙	pjr
怚	pbm
怛	pam
怜	poii
思	wp
怞	plw
怟	phpm
怠	irp
怡	pir
怢	phqo
怣	hop
怤	oip
急	nmp
急	nsp
怦	pmfj
性	phqm
怨	nup
怩	psp
怪	peg
怫	plln
怬	pw'c
怭	pph
怮	pvis
怯	pgi
怰	pyvi
怱	pkp
怲	pmob
怳	prhu
怴	piv
怵	pid
怵	pijc
怶	pdhe
怷	icp
怸	idp
怹	odp
怺	pine
总	crp
怼	eip
怽	pjd
怾	prc
怿	peq
恀	pnin
恁	ogp
恂	ppa
恃	pgdi
恄	pgr
恅	pjkp
恆	pmbm
恇	ps'mg
恈	pihq
恉	ppa
恊	pkss
恋	ycp
恌	plmo
恍	pfmu
恎	pmig
恏	vdp
恐	mnp
恑	pnmu
恒	pmam
恓	pmcw
恔	pyck
恕	vrp
恖	hwp
恗	pkms
恘	pod
恙	tgp
恚	ggp
恛	pw'r
恜	pipm
恝	qhp
恞	pkn
恟	ppu'k
恠	pklg
恡	pkki
恢	pkf
恣	iop
恣	mop
恤	phbt
恥	sjp
恦	phb'r
恧	mbp
恨	pav
恩	wkp
恪	pher
恫	pb'mr
恬	phjr
恭	tcp
恮	pomg
息	hup
恰	pomr
恱	pciu
恲	ptt
恳	avp
恴	yap
恵	jwp
恶	mcp
恷	odp
恸	pmis
恹	pmik
恺	pusu
恻	pbon
恼	pyuk
恽	pbkq
恾	ptyv
恿	nbp
悀	pnib
悁	prb
悂	pppg
悃	pw'd
悄	pfb
悅	pcru
悆	omdp
悇	pomd
悈	pit
悉	hdp
悊	qlp
悋	pykr
悌	pcnh
悍	pamj
悎	phgr
悏	pkoo
悐	kfp
悑	pijb
悒	prau
悓	pbuu
悔	powy
悕	pkkb
悖	pjbd
悗	pnau
悘	skp
悙	pyrn
悚	pdl
悛	pice
悜	prhg
悝	pwg
悞	prvk
悟	pmmr
悠	okp
悡	hnp
悢	piav
患	llp
悤	hwp
悥	ymmp
悦	pcru
悧	phdn
您	ofp
悩	pfu'k
悪	mmp
悫	gbhp
悬	bip
悭	pleg
悮	prmk
悯	plsk
悰	pjmf
悱	plmy
悲	lyp
悳	jvp
悴	pyoj
悵	psmv
悶	anp
悷	phsk
悸	phdd
悹	jrrp
悺	pjrr
悻	pgtj
悼	pyaj
悽	pjlv
悾	pjcm
悿	phkp
悿	pmkp
惀	pomb
惁	dlp
惂	pnhx
惃	papp
惄	yep
情	pqmb
惆	pb'gr
惇	pyrd
惈	pwd
惉	erp
惊	pyrf
惋	pjnu
惌	jnup
惍	pc
惎	tcp
惏	pdd
惐	pirm
惑	imp
惒	hrp
惓	pfqu
惔	pff
惕	paph
惖	ahp
惗	poip
惘	pb'tv
惙	peee
惚	pphp
惛	phpa
惜	pta
惝	pfb'r
惞	phlo
惟	pog
惠	jip
惡	mmp
惢	ppp
惣	hhp
惤	pnyi
惥	hop
惦	piyr
惧	pbmc
惨	pikh
惩	hmp
惪	jmp
惫	hewp
惬	ps'kt
惭	pkql
惮	pcwj
惯	pwjo
惰	pkmb
惱	pvvw
惲	pbjj
想	dup
惴	pumb
惵	pptd
惶	phag
惷	qap
惸	ppad
惹	tkrp
惺	pahm
惻	pbcn
惼	phsb
惽	prpa
惾	puce
惿	pamo
愀	phdf
愁	hfp
愂	jsp
愃	pjmm
愄	pwmv
愅	ptlj
愆	hnp
愇	pdmq
愈	ombp
愉	pomn
愊	pmrw
愋	pbme
愌	pnbk
愍	rkp
愎	poae
意	ytap
愐	pmw'l
愑	pnbs
愒	papv
愓	pamh
愔	pyta
愕	prrs
愖	ptmv
愗	nkp
愘	pjhr
愙	jhrp
愚	wbp
愛	bbpe
愜	ps'ko
愝	ps'av
愞	pmbk
感	irp
愠	pabt
愡	ppkp
愢	pwp
愣	pwls
愤	pjto
愥	ptlk
愦	plmo
愧	phui
愨	gep
愩	pmbc
愪	prbc
愫	pqmf
愬	tbp
愭	pjpa
愮	pbou
愯	poge
愰	pafu
愱	pkok
愲	pbbb
愳	bup
愴	poir
愵	pnmm
愶	pksb
愷	pumt
愸	dsp
愹	pjcr
愺	ptaj
愻	nfp
愼	ppbc
愽	pibi
愾	pond
愿	mfp
慀	pbvk
慁	wop
慂	ebp
慃	pcim
慄	pmwd
慅	peii
慆	pbhx
慇	hep
慈	tvip
慉	pyvw
慊	ptxc
態	ipp
慌	ptyu
慍	pwot
慎	pjbc
慏	pbac
慐	mbcp
慑	psje
慒	ptwa
慓	pmwf
慔	ptak
慕	takp
慖	pw'im
慗	dkp
慘	piih
慙	jlp
慚	pjjl
慛	puog
慜	okp
慝	srp
慞	pytj
慟	phgs
慠	pgsk
慡	pkkk
慢	pawe
慣	pwjc
慤	gep
慥	pyhr
慦	ikp
慧	qjsmp
慨	paiu
慩	pyjj
慪	ps'rr
慫	hop
慬	ptlm
慭	dkp
慮	ypwp
慯	poah
慰	sip
慱	pjii
慲	ptlb
慳	pseg
慴	psma
慵	pilb
慶	ixe
慷	pile
慸	kpblp
慹	gip
慺	pllv
慻	pfqu
慼	ifp
慽	pihf
慾	cop
慿	itp
憀	psmh
憁	phwp
憂	mbphe
憃	qxp
憄	hvp
憅	hsp
憆	pfbg
憇	htp
憈	pypm
憉	pgth
憊	obp
憋	fkp
憌	cmp
憍	phkb
憎	pcwa
憏	pbof
憐	pfdq
憑	ifp
憒	plmc
憓	pjip
憔	pogf
憕	pnot
憖	dkp
憗	dkp
憘	pgrr
憙	grtp
憚	prrj
憛	pmwj
憜	pnlb
憝	ykp
憞	pydk
憟	pmwd
憠	mop
憡	phdb
憢	pggu
憣	phdw
憤	pjtc
憥	ffbkp
憦	pffs
憧	pytg
憨	mkp
憨	nkp
憩	hup
憪	panb
憫	pank
憬	payf
憭	pkcf
憮	potf
憯	pmua
憰	pnhb
憱	pyfu
憲	jqmp
憳	psmi
憴	prxu
憵	sjp
憶	pytp
憷	pddo
憸	pomo
憹	ptwv
憺	pncr
憻	pywm
憼	tkp
憽	ptpp
憾	pirp
憿	phsk
懀	poma
懁	pwlv
懂	pthg
懃	tsp
懄	ptms
懅	pypo
懆	prrd
懇	bvp
懈	pnbq
應	iogp
懊	phbk
懋	ddp
懌	pwlj
懍	pywd
懎	pgow
懏	pogs
懐	pywv
懑	ebp
懒	pdlo
懓	pbbe
懔	pywd
懔	pywf
懕	mkp
懖	crp
懗	pgcc
懘	ebp
懙	phxc
懚	pbmp
懛	pgrg
懜	ptwn
懝	ppko
懞	ptbo
懟	tip
懠	pyx
懡	pici
懢	psmt
懣	ebp
懤	pgni
懥	pjbo
懦	pmbb
懧	pjpn
懨	pmak
懩	ptov
懪	pate
懫	phlc
懬	itlp
懭	pitc
懮	pmbe
懯	ikp
懰	phcn
懱	ptwi
懲	hkp
懳	pqjp
懴	pjim
懵	ptwu
懶	pdlc
懷	pywv
懸	bfp
懹	pyrv
懺	poim
懻	plpc
懼	pbug
懽	ptrg
懾	psjj
懿	gtiop
戀	vfp
戁	tgp
戂	picy
戃	pfbf
戄	pbue
戅	ycp
戆	yop
戇	ycp
戈	i
戉	iv
戊	ih
戋	ij
戌	ihm
戍	ihi
戎	ij
戏	ei
成	ihs
我	hqi
戒	it
戓	ir
戔	ii
戕	vmi
或	irm
戗	oui
战	yri
戙	bri
戚	ihymf
戛	mui
戜	irmg
戝	bci
戞	mbi
戟	jji
戠	yai
戡	tvi
戢	rji
戣	nki
戤	nti
戥	ami
戦	fji
戧	ori
戨	mri
戩	mai
截	jiog
戫	kbirm
戬	mai
戭	jci
戮	shi
戯	yci
戰	rji
戱	ymi
戲	yti
戳	sgi
戴	jiwtc
戵	bgi
戶	hs
户	is
戸	ms
戹	hsn
戺	hsru
戻	hsk
戼	nsmls
戽	hsyj
戽	isyj
戾	hsik
戾	isik
房	hsyhs
房	isyhs
所	hshml
扁	hsb't
扁	isb't
扂	hsyr
扃	hsb'r
扃	isb'r
扄	hshb'r
扅	hsnin
扆	hsyhv
扇	hssmm
扇	issmm
扈	hsrau
扈	israu
扉	hslmy
扉	islmy
扊	hsff
手	q
才	dh
扎	qu
扏	qkn
扐	qks
扑	qy
扒	qc
打	qmn
扔	qnhs
払	qi
扖	qo
扗	qg
托	qhp
扙	qjk
扚	qpi
扛	qm
扜	qmd
扝	qmms
扞	qmj
扟	qnj
扠	qe'i
扡	qpd
扢	qon
扣	qr
扤	qmu
扥	qqu
扦	qhj
执	qkni
扨	qsk
扩	qi
扪	qlis
扫	qsm
扫	qs'm
扬	qnsh
扭	qng
扮	qcsh
扯	qylm
扰	qiku
扱	qnhe
扲	qoin
扳	qhe
扴	qoll
扵	qoy
扶	qqo
扷	qhk
扸	qlln
批	qpp
扺	qhvp
扻	qno
扼	qmsu
扽	qpu
找	qi
承	nnqo
技	qje
抁	qihu
抂	qmg
抃	qyy
抄	qfh
抅	qpi
抆	qyk
抇	qa
抈	qb
抉	qdk
把	qau
抋	qp
抌	qlbu
抍	qht
抎	qmmi
抏	qmmu
抐	qob
抑	qhvl
抒	qnin
抓	qhlo
抔	qmf
投	qhne
抖	qyj
抗	qyhn
折	qhml
抙	qq
抚	qmku
抛	qkns
抜	qke
抝	qvis
択	qso
抟	qqni
抠	qs'k
抡	qop
抢	qosu
抣	qpmm
护	qis
报	qsle
抦	qmob
抧	qrc
抨	qmfj
抩	qgb
抪	qklb
披	qdhe
抬	qir
抭	qjhu
抮	qohh
抯	qbm
抰	qlbk
抱	qpru
抲	qmnr
抳	qsp
抴	qpt
抵	qhpm
抵	qhvi
抶	qhqo
抷	qmfm
抸	qhio
抹	qdj
抺	qjd
抻	qlwl
押	qwl
抽	qlw
抾	qgi
抿	qrvp
拀	qrhu
拁	qksr
拂	qlln
拃	qos
拄	qyg
担	qam
拆	qhmy
拇	qwy'i
拈	qyr
拉	qyt
拊	qodi
拋	qkus
拌	qfq
拍	qha
拎	qoii
拏	veq
拐	qrks
拐	qrsh
拑	qt'm
拒	qss
拓	qmr
拔	qike
拔	qikk
拕	qjp
拖	qopd
拗	qvis
拘	qpr
拙	quu
拚	qit
招	qshr
拜	hqmqj
拝	qmqj
拞	qom
拟	qvio
拠	qhen
拡	qii
拢	qikp
拣	qkvd
拤	qymy
拥	qb'q
拦	qtmm
拧	qjmn
拨	qive
择	qeq
拪	qmcw
拫	qav
括	qhjr
拭	qipm
拮	qgr
拯	qnem
拰	qohg
拱	qtc
拲	tcq
拳	fqq
拴	qomg
拵	qkld
拶	qvvn
拷	qjks
拸	qnin
拹	qkss
拺	qdb
拻	qkf
拼	qtt
拽	qlwp
拾	qomr
拿	orq
挀	qhhv
持	qgdi
挂	qgg
挃	qmig
挄	qfmu
挅	qnsd
挆	qhnd
指	qpa
挈	qhq
按	qjv
挊	qymy
挋	qs'll
挌	qher
挍	qyck
挎	qkms
挏	qb'mr
挐	vrq
挑	qlmo
挒	qmnn
挓	qjhp
挔	qyhv
挕	qsj
挖	qjcn
挗	qkn
挘	qfhs
挙	fcq
挚	qiq
挛	ycq
挜	qmtc
挝	qydi
挞	qyk
挟	qkt
挠	qjpu
挡	qfsm
挡	qfs'm
挢	qhkl
挣	qnsd
挤	qykl
挥	qbkq
挦	qsmi
挧	qsmm
挨	qiok
挩	qcru
挪	qsql
挫	qoog
挬	qjbd
挭	qmlk
挮	qcnh
振	qmmv
挰	qrhg
挱	qefh
挲	ehq
挳	qmvm
挴	qowy
挵	qmgt
挶	qss'r
挷	qqjl
挸	qbuu
挹	qrau
挺	qnkg
挻	qnkm
挼	qbv
挽	qnau
挾	qkoo
挿	qhjl
捀	qhej
捁	qhgr
捂	qmmr
捃	qskr
捄	qije
捅	qnib
捆	qw'd
捇	qglc
捈	qomd
捉	qryo
捊	qbnd
捋	qbdi
捌	qrsn
捍	qamj
捎	qfb
捏	qag
捐	qrb
捑	qavk
捒	qdl
捓	qmhl
捔	qnb'g
捕	qijb
捖	qjmu
捗	qylh
捘	qice
捙	qjwj
捚	qwg
捛	qrhr
捜	qlwe
捝	qcru
捞	qtbs
损	qrbo
捠	qomc
捡	qomm
换	qnbk
捣	qpyu
捤	qshu
捥	qjnu
捦	qc
捧	qqkq
捨	qomr
捩	qhsk
捩	qisk
捪	qhpa
捫	qan
捬	qioi
捭	qhwj
据	qsjr
捯	qmgn
捰	qwd
捱	qmgg
捲	qfqu
捳	qomu
捴	qcip
捵	qtbc
捶	qhjm
捷	qjlo
捸	qle
捹	qkjt
捺	qkmf
捻	qoip
捼	qhdv
捽	qyoj
捾	qjrr
捿	qjlv
掀	qhlo
掁	qsmv
掂	qiyr
掃	qsmb
掄	qomb
掅	qqmb
掆	qb'tu
掇	qeee
授	qbbe
掉	qyaj
掊	qytr
掋	qihm
掌	fbrq
掍	qapp
掎	qkmr
掏	qpou
掐	qnhx
掑	qtmc
排	qlmy
掓	qyfe
掔	seq
掕	qgce
掖	qyok
掗	qmlm
掘	qsuu
掙	qbsd
掚	qmlb
掛	qggy
掜	qhxu
掝	qirm
掞	qff
掟	qjmo
掠	qyrf
採	qbd
探	qbcd
掣	hnq
掤	qbb
接	qytv
掦	qaph
控	qjcm
推	qog
掩	qklu
措	qta
掫	qsje
掬	qpfd
掭	qhkp
掭	qmkp
掮	qhsb
掮	qisb
掯	qymb
掰	qchq
掱	qqq
掲	qapp
掳	qyps
掴	qw'mi
掵	qoml
掶	qilo
掷	qtkl
掸	qcwj
掹	qndt
掺	qikh
掻	qeli
掼	qwjo
掽	qttc
掾	qvno
掿	qtkr
揀	qdw'f
揁	qybc
揂	qtcw
揃	qtbn
揄	qomn
揅	mtq
揆	qnok
揇	qjb'j
揈	qpyr
揉	qnhd
揊	qmrw
揋	qwmv
揌	qwp
揍	qqkk
揎	qjmm
描	qtw
提	qamo
揑	qhxm
插	qhjx
揓	qysd
揔	qpkp
揕	qtmv
揖	qrsj
揗	qhju
揘	qhag
揙	qhsb
揚	qamh
換	qnbk
揜	qort
揝	qhoa
揞	qyta
揟	qnob
揠	qs'av
握	qsmg
揢	qjhr
揣	qumb
揤	qail
揥	qybb
揦	qdln
揧	dnq
揨	qyrn
揩	qppa
揪	qhdf
揫	hfq
揬	qjck
揭	qapv
揮	qbjj
揯	qpmm
揰	qhjg
揱	fnq
揲	qptd
揳	qqhk
援	qbme
揵	qnkq
揶	qsjl
揷	qhjx
揸	qdam
揹	qlpb
揺	qbmu
揻	qihv
揼	qmre
揽	qliu
揾	qabt
揿	qopo
搀	qnuy
搁	qlsr
搂	qfdv
搃	qcrp
搄	qpmm
搅	qfbu
搆	qttb
搇	qoiv
搈	qjcr
搉	qobg
搊	qpuu
搋	qhyn
搋	qhyu
搌	qstv
損	qrbc
搎	qndf
搏	qibi
搐	qyvw
搑	qtsj
搒	qybs
搓	qtqm
搔	qeii
搕	qgit
搖	qbou
搗	qhau
搘	qjpa
搙	qmvi
搚	qksb
搛	qtxc
搜	qhxe
搝	qhuk
搞	qyrb
搟	qjjj
搠	qtub
搡	qeed
搢	qmia
搣	qihf
搤	qtct
搥	qyhr
搦	qnmm
搧	qhsm
搨	qasm
搩	qnqd
搪	qilr
搫	heq
搬	qhye
搭	qtor
搮	qmwd
搯	qbhx
搰	qbbb
搱	qsyj
搲	qjco
搳	qjqr
搴	jtcq
搵	qwot
搶	qoir
搷	qjbc
搸	qqkd
搹	qmrb
携	qogs
搻	orqq
搼	qfqq
搽	qtod
搾	qjcs
搿	hqorq
搿	qorq
摀	qhrf
摁	qwkp
摂	qsjo
摃	qmbc
摄	qsje
摅	qypp
摆	qwli
摇	qbou
摈	qjoc
摉	qjcn
摊	qeog
摋	qkce
摌	qyhm
摍	qjoa
摎	qsmh
摏	qqkx
摐	qhoo
摑	qw'im
摒	qstt
摓	qyhj
摔	qyij
摕	qkpb
摖	qbof
摗	qdlo
摘	qycb
摙	qyjj
摚	qfbg
摛	qyub
摜	qwjc
摝	qixp
摞	qwvf
摟	qllv
摠	qhwp
摡	qaiu
摢	qypd
摣	qypm
摤	qkkk
摥	qoah
摦	qkso
摧	quog
摨	qseq
摩	icq
摩	idq
摪	qvmi
摫	qqou
摬	qytu
摭	qitf
摮	gkq
摯	giq
摰	giq
摱	qawe
摲	qjjl
摳	qs'rr
摴	qmbs
摵	qihf
摶	qjii
摷	qvvd
摸	qtak
摹	takq
摺	qsma
摻	qiih
摼	qseg
摽	qmwf
摾	qnii
摿	qoya
撀	geq
撁	qyvq
撂	qwhr
撃	jeq
撄	qbov
撅	qmto
撆	fkq
撇	qfbk
撈	qffs
撉	ykq
撊	qanb
撋	qang
撌	qlmc
撍	qmua
撎	qgbt
撏	qsmi
撐	qfbh
撑	qfbq
撒	qtbk
撓	qggu
撔	qayf
撕	qtcl
撖	qmjk
撖	qnjk
撗	qtlc
撘	qhor
撙	qtwi
撚	qbkf
撛	qfdq
撜	qnot
撝	qbhf
撝	qikf
撞	qytg
撟	qhkb
撠	qjji
撡	qiip
撢	qmwj
撣	qrrj
撤	qybk
撥	qnoe
撦	qkja
撧	qvfu
撨	qogf
撩	qkcf
撪	qikj
撫	qotf
撬	qhuu
播	qhdw
撮	qase
撯	qtqu
撰	qruc
撱	qnlb
撲	qtco
撳	qcno
撴	qydk
撵	qqoq
撶	qtmj
撷	qgro
撸	qnwa
撹	qfbu
撺	qjcl
撻	qygq
撼	qirp
撽	qhsk
撾	qybb
撿	qomo
擀	qjjj
擁	qyvg
擂	qmbw
擃	qtwv
擄	qyps
擅	qywm
擆	qtja
擇	qwlj
擈	qtcd
擉	qwli
擊	jeq
擋	qfbw
擌	qhko
操	qrrd
擎	tkq
擏	qtrk
擐	qwlv
擑	qrji
擒	qoyb
擓	qs'eg
擔	qncr
擕	qogs
擖	qtav
擗	qsrj
擘	sjq
擙	qhbk
據	qypo
擛	qtpd
擜	qjbk
擝	qabt
擞	qfvk
擟	qmfb
擠	qyx
擡	qgrg
擢	qsmg
擣	qgni
擤	qhul
擥	swq
擦	qjbf
擧	hcq
擨	qhuo
擩	qmbb
擪	mkq
擫	qmak
擬	qpko
擭	qtoe
擮	qjig
擯	qjmc
擰	qjpn
擱	qanr
擲	qtkl
擳	qhal
擴	qitc
擵	qicq
擶	qhtn
擷	qgrc
擸	qvvv
擹	qtoo
擺	qwlp
擻	qlvk
擼	qnwa
擽	qvid
擾	qmbe
擿	qyyb
攀	ddkq
攁	qtov
攂	qwww
攃	qtbf
攄	qypp
攅	qqoc
攆	qqoj
攇	qjqp
攈	qipd
攉	qmbg
攊	qmhm
攋	qdlc
攌	qw'wv
攍	qynv
攎	qypt
攏	qybp
攐	qjtv
攑	qhcq
攒	qhuo
攓	qjto
攔	qanw
攕	qoim
攖	qbcv
攗	qipd
攘	qyrv
攙	qnri
攚	qffr
攛	qjcv
攜	quob
攝	qsjj
攞	qwlg
攟	qipw
攠	qicy
攡	qybg
攢	qhuc
攣	vfq
攤	qtog
攥	qhbf
攦	qmmp
攧	qjcc
攨	qjco
攩	qfbf
攪	qhbu
攫	qbue
攬	qswu
攭	qvoi
攮	qjbv
支	je
攰	jeks
攱	ytje
攲	krje
攳	jesmi
收	vlok
攷	msok
攸	olok
改	suok
改	svok
攺	ruok
攻	mok
攼	mjok
攽	chok
放	ysok
政	mmok
敀	haok
敁	yrye
敂	prok
敃	rpok
敄	nhok
故	jrok
敆	orye
敇	dbok
效	ykok
敉	fdok
敊	yfye
敋	hrok
敌	hrok
敍	odye
敎	kdok
敏	oyok
敐	mvok
救	ieok
敒	ollk
敓	cuok
敔	mrok
敕	dlok
敖	gsok
敖	qsok
敗	bcok
敘	odok
教	jdok
敚	cuok
敛	omok
敜	opok
敝	fbok
敞	fbok
敟	tcok
敠	eeeee
敡	ahye
敢	mjok
敢	njok
散	tbok
敤	wdye
敥	ffye
敦	ydok
敧	krye
敨	yrok
敩	fdok
敪	eeeek
敫	hsok
敬	trok
敭	ahok
敮	mxye
敯	raye
数	fvok
敱	utye
敲	ybye
敳	utok
整	dkmym
敵	ybok
敶	nldwk
敷	isok
數	lvok
敹	ydok
敺	srye
敻	nbbue
敼	grye
敽	hbye
敾	trok
敿	hbok
斀	wiye
斁	wjok
斂	oook
斃	fkmnp
斄	jkmdo
斅	hdye
斆	hdok
文	yk
斈	yknd
斉	yksl
斊	yksj
斋	ykmb'l
斌	ykmpm
斍	ykbuu
斎	yklml
斏	ykiav
斐	lyyk
斑	mgykg
斒	ykhsb
斓	yklsw
斔	yihxo
斕	ykanw
斖	ykhbm
斗	yj
斘	niyj
料	fdyj
斚	iibyj
斛	nbyj
斜	odyj
斝	rrbyj
斞	hoyj
斟	tvyj
斠	tbyj
斡	jjoyj
斢	tcyj
斣	wiyj
斤	hml
斥	hmy
斦	hlhml
斧	ckhml
斨	vmhml
斩	kqhml
斪	prhml
斫	mrhml
斬	jjhml
断	vdhml
斮	tahml
斯	tchml
新	ydhml
斱	jahml
斲	rmhml
斳	tmhml
斴	fqhml
斵	hmhml
斶	hlwli
斷	vihml
斸	sihml
方	yhs
斺	ysoll
斻	ysohn
於	ysoy
施	ysopd
斾	ysolb
斿	ysond
旀	ysif
旁	ybyhs
旂	ysohl
旃	ysoby
旄	ysohu
旅	ysohv
旆	ysojb
旇	ysode
旈	ysyiu
旉	ibyhs
旊	ysomn
旋	ysono
旌	ysohm
旍	ysooi
旎	ysosp
族	ysook
旐	ysolo
旑	yskmr
旒	ysoyu
旓	ysofb
旔	ysnkq
旕	yyrp
旖	ysokr
旗	ysotc
旘	ysyia
旙	yshdw
旚	ysomf
旛	ysohw
旜	ysoym
旝	ysooa
旞	ysyoo
旟	ysohc
无	mku
旡	mvku
既	aimvu
旣	hpmvu
旤	bbmvu
日	a
旦	am
旧	la
旨	pa
早	aj
旪	aj
旫	ash
旬	pa
旭	kna
旮	kna
旯	akn
旰	amj
旱	amj
旲	ak
旳	api
旴	amd
旵	au
时	adi
旷	ai
旸	ansh
旹	uma
旺	amg
旻	ayk
旼	ayk
旽	apu
旾	pua
旿	aoj
昀	apim
昀	apmm
昁	ajb
昂	ahvl
昃	amo
昄	ahe
昅	anhe
昆	app
昇	aht
昈	ahs
昉	ayhs
昊	amk
昋	hka
昌	aa
昍	aa
明	ab
昏	hpa
昐	acsh
昑	aoin
昒	aphh
易	aphh
昔	ta
昕	ahml
昖	aci
昗	ayc
昘	ayhs
昙	ammi
昚	kca
昛	ass
昜	amsh
昝	hoa
昝	hya
昞	amob
星	ahqm
映	albk
昡	ayvi
昢	auu
昣	aohh
昤	aoii
春	qka
昦	akll
昧	ajd
昨	aos
昩	adj
昪	ait
昫	apr
昬	rpa
昭	ashr
昮	amks
是	amyo
昰	amym
昱	ayt
昲	alln
昳	ahqo
昴	ahhl
昵	asp
昶	iea
昷	abt
昸	ahey
昹	aine
昺	amob
昻	amsl
昼	soam
昽	aikp
显	atc
昿	aii
晀	almo
晁	almo
時	agdi
晃	afmu
晄	afmu
晅	amam
晆	agg
晇	akms
晈	ayck
晉	miia
晊	amig
晋	mca
晌	ahb'r
晍	ab'mr
晎	atc
晏	ajv
晐	ayvo
晑	ahb'r
晒	amcw
晓	ajpu
晔	aopj
晕	abkq
晖	abkq
晗	aoir
晘	aamj
晙	aice
晚	anau
晛	abuu
晜	acnh
晝	lgam
晞	akkb
晟	aihs
晠	aihs
晡	aijb
晢	qla
晣	aqhl
晤	ammr
晥	ajmu
晦	aowy
晧	ahgr
晨	ammv
晩	anau
晪	atbc
晫	ayaj
晬	ayoj
晭	ab'gr
普	tca
景	ayrf
晰	adhl
晱	aff
晲	ahxu
晳	dla
晴	aqmb
晵	hka
晶	aaa
晷	ahor
晷	ahyr
晸	ammk
晹	aaph
智	ora
晻	aklu
晼	ajnu
晽	add
晾	ayrf
晿	aaa
暀	ahog
暁	ajtu
暂	kla
暃	almy
暄	ajmm
暅	apmm
暆	aysd
暇	arse
暈	abjj
暉	abjj
暊	ambc
暋	rka
暌	anok
暍	aapv
暎	atlk
暏	ajka
暐	admq
暑	ajka
暒	aahm
暓	nka
暔	ajb'j
暕	adw'f
暖	abme
暗	ayta
暘	aamh
暙	aqka
暚	abou
暛	atqm
暜	yta
暝	abac
暞	ahud
暟	aumt
暠	ayrb
暡	acim
暢	llamh
暣	aond
暤	ahaj
暥	aajv
暦	mdda
暧	abbe
暨	auam
暩	abof
暪	atlb
暫	jla
暬	gia
暭	ahaj
暮	taka
暯	atak
暰	ahoo
暱	as'tr
暲	aytj
暳	aqjs
暴	atce
暵	atlo
暶	ayso
暷	ajii
暸	akcf
暹	yaog
暺	arrj
暻	aayf
暼	fka
暽	afdq
暾	aydk
暿	agrr
曀	agbt
曁	huam
曂	atlc
曃	ayle
曄	atmj
曅	atmj
曆	mhda
曇	ambi
曈	aytg
曉	aggu
曊	alnc
曋	amwj
曌	abjcm
曍	ahuj
曎	awlj
曏	avhl
曐	aaam
曑	aaah
曒	ahsk
曓	auuj
曔	atrk
曕	ancr
曖	abbe
曗	atcd
曘	ambb
曙	awla
曚	atbo
曛	ahgf
曜	asmg
曝	aate
曞	amtb
曟	aaav
曠	aitc
曡	aaam
曢	ajkf
曣	atlf
曤	ambg
曥	aypt
曦	atgs
曧	ambi
曨	aybp
曩	ayrv
曪	awlg
曫	vfa
曬	ammp
曭	afbf
曮	arrk
曯	asei
曰	a
曱	wmll
曲	tw
曳	lwp
更	mlwk
曵	ilwp
曶	pha
曷	apv'o
書	lga
曹	twa
曺	jwa
曻	aniq
曼	awle
曽	cwa
曾	cwa
替	qoa
最	asje
朁	mua
朂	asjs
會	omwa
朄	lldw'f
朅	giapv
朆	caphh
朇	oahwj
月	b
有	kb
朊	bmmu
朋	bb
朌	bcsh
服	bsle
朎	boii
朏	buu
朐	bpr
朑	bpt
朒	bob'o
朓	blmo
朔	tub
朕	btk
朖	biav
朗	iib
朘	bice
朙	wbb
朚	yvab
望	ybhg
望	ybmg
朜	byrd
朝	jjb
朞	tcb
期	tcb
朠	btlk
朡	buce
朢	sbhg
朣	bytg
朤	bbbb
朥	bffs
朦	btbo
朧	bybp
木	d
朩	dc
未	jd
末	dj
本	dm
札	du
朮	ijc
术	id
朰	dn
朱	hjd
朲	do
朳	dc
朴	dy
朵	hnd
朶	nsd
朷	dsh
朸	dks
朹	dkn
机	dhn
朻	dvl
朼	dp
朽	dmvs
朾	dmn
朿	db
杀	kd
杁	do
杂	knd
权	de
杄	dhj
杅	dmd
杆	dmj
杇	dmms
杈	de'i
杉	dhhh
杊	dlll
杋	dhn'i
杌	dmu
杍	dnd
李	dnd
杏	dr
材	ddh
村	ddi
杒	dshi
杓	dpi
杔	dhp
杕	dk
杖	djk
杗	yvd
杘	sd
杙	dip
杚	don
杛	dn
杜	dg
杝	dpd
杞	dsu
束	dl
杠	dm
条	hed
杢	dm
杣	du
杤	dms
来	dt
杦	dno
杧	dyv
杨	dnsh
杩	dnvm
杪	dfh
杫	dylm
杬	dmmu
杭	dyhn
杮	djb
杯	dmf
杰	df
東	dw
杲	ad
杳	da
杴	dno
杵	doj
杶	dpu
杷	dau
杸	dhne
杹	dop
杺	dp
杻	dng
杼	dnin
杽	dq
松	dci
板	dhe
枀	cid
极	dnhe
枂	db
枃	dpmm
构	dpi
枅	dmt
枆	dhqu
枇	dpp
枈	ppd
枉	dmg
枊	dhvl
枋	dyhs
枌	dcsh
枍	dcms
枎	dqo
枏	dbmm
析	dhml
枑	dmvm
枒	dmvh
枓	dyj
枔	doin
枕	dlbu
枖	dhk
林	dd
枘	dob
枙	dmsu
枚	dok
枛	dhlo
果	wd
枝	dje
枞	doo
枟	dmmi
枠	dknj
枡	dht
枢	ds'k
枣	dby
枤	dik
枥	dmks
枦	dhs
枧	dbhu
枨	dpo
枩	dci
枪	dosu
枫	dhn'k
枬	dby
枭	pysd
枮	dyr
枯	djr
枰	dmfj
枱	dir
枲	ird
枳	drc
枴	drsh
枵	drms
架	krd
枷	dksr
枸	dpr
枹	dpru
枺	ddj
枻	dpt
枼	ptd
枽	jtd
枾	dqll
枿	djt
柀	ddhe
柁	djp
柂	dopd
柃	doii
柄	dmob
柅	dsp
柆	dyt
柇	dhd
柈	dfq
柉	dhio
柊	dhey
柋	opd
柌	dsmr
柍	dlbk
柎	dodi
柏	dha
某	tmd
柑	dt'm
柒	epd
染	end
柔	nhd
柕	dnih
柖	dshr
柗	dcr
柘	dmr
柙	dwl
柚	dlw
柛	dlwl
柜	dss
柝	dhmy
柞	dos
柟	dgb
柠	djmn
柡	dmme
柢	dhpm
柢	dhvi
柣	dhqo
柤	dbm
查	dam
柦	dam
柧	dhvo
柨	dklb
柩	ds'no
柪	dvis
柫	dlln
柬	dw'f
柭	dikk
柮	duu
柯	dmnr
柰	dmmf
柱	dyg
柲	dph
柳	dhhl
柴	ypd
柵	dbt
柶	dw'c
柷	drhu
柸	dmfm
柹	dlxh
柺	drks
査	dbm
柼	djc
柽	deg
柾	dmym
柿	dylb
栀	dhmu
栁	dnil
栂	dwy'i
栃	dhms
栄	fbd
栅	dbbm
栆	kly
标	dmmf
栈	dij
栉	dtsl
栊	dikp
栋	dkd
栌	dys
栍	dhqm
栎	dhvd
栏	dtmm
栐	dine
树	dedi
栒	dpa
栓	domg
栔	qhd
栕	ds'll
栖	dmcw
栗	mwd
栘	dnin
栙	dheq
栚	dtk
栛	dkss
栜	ddb
栝	dhjr
栞	mjd
栟	dtt
栠	ogd
校	dyck
栢	dma
栣	dohg
栤	dime
栥	mod
栦	dill
栧	dlwp
栨	dmmo
栩	dsmm
株	dhjd
栫	dkld
栬	dnau
栭	dmb'l
栮	dsj
栯	dkb
栰	doi
栱	dtc
栲	djks
栳	djkp
栴	doby
栵	dmnn
栶	dw'k
样	dtq
核	dyvo
根	dav
栺	dpa
栻	dipm
格	dher
栽	jid
栾	ycd
栿	doik
桀	nqd
桁	dhon
桂	dgg
桃	dlmo
桄	dfmu
桅	dnmu
框	ds'mg
桇	vrd
案	jvd
桉	djv
桊	fqd
桋	dkn
桌	yad
桍	dkms
桎	dmig
桏	dmnl
桐	db'mr
桑	eeed
桒	jtd
桓	dmam
桔	dgr
桕	dhx
桖	dhbt
桗	dnsd
桘	dhrr
桙	dihq
桚	dvvn
桛	dymy
桜	dfv
桝	dniq
桞	dnil
桟	diq
桠	dmtc
桡	djpu
桢	dybo
档	dfsm
档	dfs'm
桤	dusu
桥	dhkl
桦	dopj
桧	domi
桨	lnd
桩	dig
桪	dsmi
桫	defh
桬	ehd
桭	dmmv
桮	dmfr
桯	drhg
桰	dhpr
桱	dmvm
桲	djbd
桳	dikj
桴	dbnd
桵	dbv
桶	dnib
桷	dnb'g
桷	dnb'q
桸	dkkb
桹	diav
桺	dmls
桻	dhej
桼	doe
桽	doog
桾	dskr
桿	damj
梀	ddl
梁	ecd
梁	eid
梂	dije
梃	dnkg
梄	dmcw
梅	dowy
梆	dqjl
梇	dmgt
梈	dyrn
梉	dvmg
梊	qld
梋	drb
梌	domd
梍	dhap
梎	dhap
梏	dhgr
梐	dppg
梑	dkhf
梒	doir
梓	dytj
梔	dhmu
梕	dsip
梖	dbuc
梗	dmlk
梘	dbuu
梙	dll
梚	dnau
梛	dsql
梜	dkoo
條	olod
梞	dsup
梟	hayd
梠	drhr
梡	djmu
梢	dfb
梣	duon
梤	duch
梥	jcid
梦	ddn'i
梧	dmmr
梨	hnd
梩	dwg
梪	dmrt
梫	dsme
梬	dlws
梭	dice
梮	dss'r
梯	dcnh
械	dit
梱	dw'd
梲	dcru
梳	dyiu
梴	dnkm
梵	ddhn'i
梶	dshu
梷	yed
梸	dhdn
梹	domc
梺	ddmy
梻	doln
梼	dqki
梽	dgp
梾	ddt
梿	dykq
检	domm
棁	dcru
棂	dsmf
棃	hhd
棄	yitd
棅	dhdl
棆	domb
棇	dcip
棈	dqmb
棉	dhab
棊	tcd
棋	dtmc
棌	dbd
棍	dapp
棎	dbcd
棏	dami
棐	lyd
棑	dlmy
棒	dqkq
棓	dytr
棔	dhpa
棕	djmf
棖	dsmv
棗	dbdb
棘	dbdb
棙	dhsk
棚	dbb
棛	dyib
棜	dysy
棝	dw'jr
棞	dw'hd
棟	ddw
棠	fbrd
棡	db'tu
棢	db'tv
棣	dle
棤	dta
棥	dkkd
棦	dbsd
棧	dii
棨	hkd
棩	dlxl
棪	dff
棫	dirm
棬	dfqu
棭	dyok
森	ddd
棯	doip
棰	dhjm
棱	dgce
棲	djlv
棳	deee
棴	dbse
棵	dwd
棶	ddoo
棷	dsje
棸	sed
棹	dyaj
棺	djrr
棻	tcsd
棼	ddcsh
棽	ddoin
棾	ddbhn
棿	dhxu
椀	djnu
椁	dyrd
椂	dvne
椃	dypu
椄	dytv
椅	dkmr
椆	db'gr
椇	dbmc
椈	dpfd
椉	ynqd
椊	dyoj
椋	dyrf
椌	djcm
植	djbm
椎	dog
椏	dmlm
椐	dsjr
椑	dhwj
椒	dyfe
椓	dmso
椔	dvvw
椕	dchd
椖	dhss
椗	djmo
椘	ddino
椙	daa
椚	dan
椛	dtop
検	domo
椝	qud
椞	dld
椟	djnk
椠	kld
椡	dmgn
椢	dw'mi
椣	dtbc
椤	dwln
椥	dokr
椦	dfqs
椧	doml
椨	dioi
椩	dilo
椪	dttc
椫	dcwj
椬	djbm
椭	dnlb
椮	dikh
椯	dumb
椰	dsjl
椱	doae
椲	ddmq
椳	dwmv
椴	dhje
椵	drse
椶	duce
椷	dihr
椸	dysd
椹	dtmv
椺	dord
椻	ds'av
椼	dhon
椽	dvno
椾	dtbn
椿	dqka
楀	dhlb
楁	djhr
楂	ddam
楃	dsmg
楄	dhsb
楅	dmrw
楆	dmwv
楇	dbb'r
楈	dnob
楉	dtkr
楊	damh
楋	ddln
楌	dyhh
楍	drrr
楎	dbjj
楏	dkgg
楐	dwol
楑	dnok
楒	dwp
楓	dhn'i
楔	dqhk
楕	dkmb
楖	dail
楗	dnkq
楘	nkd
楙	dnhd
楚	ddnyo
楛	dtjr
楜	djrb
楝	ddw'f
楞	dwls
楟	dyrn
楠	djb'j
楡	domv
楢	dtcw
楣	dahu
楤	dpkp
楥	dbme
楦	djmm
楧	dtlk
楨	dybc
楩	domk
楪	dptd
楫	drsj
楬	dapv
業	tctd
楮	djka
楯	dhju
楰	dhxo
楱	dqkk
楲	dihv
楳	dtmd
楴	dybb
極	dmem
楶	mord
楷	dppa
楸	dhdf
楹	dnst
楺	dnhd
楻	dhag
楼	dfdv
楽	iod
楾	dhae
楿	dhda
榀	drrr
榁	djmg
概	daiu
榃	ddw
榄	dliu
榅	dabt
榆	domn
榇	dytd
榈	dlsr
榉	dfcq
榊	difl
榋	dsms
榌	dnoo
榍	dsfb
榎	dmue
榏	dtct
榐	dstv
榑	dibi
榒	dnmm
榓	dpht
榔	diil
榕	djcr
榖	gdhne
榗	dmia
榘	osd
榙	dtor
榚	dtgf
榛	dqkd
榜	dybs
榝	dkde
榞	dmhf
榟	djyj
榠	dbac
榡	dqmf
榢	djmo
榣	dbou
榤	dnqd
榥	dafu
榦	jjod
榧	ds'ly
榨	djcs
榩	dypk
榪	dsqf
榫	dogj
榬	dgrv
榭	dhhi
榮	ffbd
榯	dagi
榰	djpa
榱	dywv
榲	dwot
榳	ding
榴	dhhw
榵	dtsj
榶	dilr
榷	dobg
榸	dgwg
榹	dhyu
榺	bfqd
榻	dasm
榼	dgit
榽	dbvk
榾	dbbb
榿	dumt
槀	yrbd
槁	dyrb
槂	dndf
槃	hed
槄	dbhx
槅	dmrb
槆	dtpa
槇	dpbc
槈	dmvi
槉	dkok
槊	tbd
構	dttb
槌	dyhr
槍	doir
槎	dtqm
槏	dtxc
槐	dhui
槑	rdrd
槒	dyvw
槓	dmbc
槔	dhaj
槕	dyad
槖	gbmd
槗	dkrb
様	dtge
槙	djbc
槚	dmwo
槛	dlit
槜	dogs
槝	dhau
槞	dytu
槟	djoc
槠	diva
槡	deed
槢	dsma
槣	djkr
槤	dyjj
槥	dqjm
槦	dilb
槧	jld
槨	dydl
槩	hud
槪	dhpu
槫	djii
槬	dkso
槭	dihf
槮	diih
槯	duog
槰	dyhj
槱	dmwf
槲	dnbj
槳	vid
槴	dhsu
槵	dllp
槶	dw'im
槷	gid
槸	dggi
槹	dhaj
槺	dile
槻	dqou
槼	qud
槽	dtwa
槾	dawe
槿	dtlm
樀	dycb
樁	dqkx
樂	vid
樃	diib
樄	dnlw
樅	dhoo
樆	dyub
樇	dolb
樈	dytu
樉	dkkk
樊	ddk
樋	dynb
樌	dwjc
樍	dqmc
樎	djoa
樏	dwvf
樐	dyw'i
樑	deid
樒	djpu
樓	dllv
樔	dvvd
樕	ddlo
樖	ordmr
樗	dmbs
樘	dfbg
標	dmwf
樚	dixp
樛	dsmh
樜	ditf
樝	dypm
樞	ds'rr
樟	dytj
樠	dtlb
模	dtak
樢	dhaf
樣	dtge
樤	dold
樥	dthj
樦	dhyg
樧	dkce
樨	dseq
権	dokg
横	dtlc
樫	dseg
樬	dhwp
樭	dtcg
樮	dmwf
樯	dgcw
樰	dmbs
樱	dbov
樲	dipc
樳	dsmi
樴	dyia
樵	dogf
樶	dase
樷	ddsje
樸	dtco
樹	dgti
樺	dtmj
樻	dlmc
樼	dsnd
樽	dtwi
樾	dgov
樿	drrj
橀	dyit
橁	dhpa
橂	dtwk
橃	dnoe
橄	dmjk
橄	dnjk
橅	dotf
橆	otdd
橇	dhuu
橈	dggu
橉	dfdq
橊	dmlw
橋	dhkb
橌	danb
橍	dang
橎	dhdw
橏	dtgr
橐	jbmrd
橑	dkcf
橒	dmbi
橓	dbbq
橔	dydk
橕	dfbh
橖	dfbd
橗	dtab
橘	dnhb
橙	dnot
橚	dlx
橛	dmto
橜	mod
橝	dmwj
橞	djip
機	dvii
橠	dynv
橡	dnao
橢	dnlb
橣	djpb
橤	pppd
橥	kad
橦	dytg
橧	dcwa
橨	djtc
橩	dffn
橪	dbkf
橫	dtmc
橬	dmua
橭	djrj
橮	dhhc
橯	dffs
橰	dhuj
橱	dmmi
橲	dgrr
橳	dbfs
橴	dypf
橵	dtbk
橶	djji
橷	dlpn
橸	daaa
橹	dnwa
橺	dana
橻	dngg
橼	dvmo
橽	dygq
橾	drrd
橿	dmwm
檀	dywm
檁	dywd
檂	dtwv
檃	nmd
檄	dhsk
檅	dymh
檆	dffr
檇	dogs
檈	dwlv
檉	dsrg
檊	djjj
檋	dtcj
檌	dwly
檍	dytp
檎	doyb
檏	dtcd
檐	dncr
檑	dmbw
檒	ddhn'i
檓	dhge
檔	dfbw
檕	jed
檖	dyto
檗	sjd
檘	dsrj
檙	dbul
檚	dddo
檛	dybb
檜	doma
檝	drji
檞	dnbq
檟	dmwc
檠	tkd
檡	dwlj
檢	domo
檣	dgow
檤	dytu
檥	dtgi
檦	dmfn
檧	dtpp
檨	dtgo
檩	dywf
檪	diod
檫	djbf
檬	dtbo
檭	dcav
檮	dgni
檯	dgrg
檰	dvfb
檱	dhtc
檲	dw'ji
檳	djmc
檴	dtoe
檵	dvvi
檶	dks'r
檷	dmfb
檸	djpn
檹	dysr
檺	dyro
檻	dsit
檼	dbmp
檽	dmbb
檾	ffbdd
檿	mkd
櫀	dtcf
櫁	djpi
櫂	dsmg
櫃	ds'lc
櫄	dhgf
櫅	dyx
櫆	dhij
櫇	ddec
櫈	dntn
櫉	dmgi
櫊	danr
櫋	dhus
櫌	dmbe
櫍	dhlc
櫎	ditc
櫏	dymu
櫐	wwwd
櫑	dwww
櫒	dtbf
櫓	dnwa
櫔	dmtb
櫕	dqoc
櫖	dypp
櫗	dtwi
櫘	dqjp
櫙	dts'r
櫚	danr
櫛	dhal
櫜	jbhod
櫝	dgwc
櫞	dvfo
櫟	dvid
櫠	dine
櫡	dhja
櫢	dlvk
櫣	dytj
櫤	dhtn
櫥	digi
櫦	dixe
櫧	dyra
櫨	dypt
櫩	danx
櫪	dmhm
櫫	mad
櫬	dydu
櫭	daum
櫮	dmgr
櫯	dnfd
櫰	dywv
櫱	ujd
櫲	dnno
櫳	dybp
櫴	ddlc
櫵	dtof
櫶	djqp
櫷	dnxu
櫸	dhcq
櫹	dtlx
櫺	dmbr
櫻	dbcv
櫼	doim
櫽	npd
櫾	dbuf
櫿	dffr
欀	dyrv
欁	dtvd
欂	dtei
欃	dnri
欄	danw
欅	dhcq
欆	doge
欇	dsjj
欈	duob
欉	dtce
權	dtrg
欋	dbug
欌	dtis
欍	dtox
欎	ddbai
欏	dwlg
欐	dmmp
欑	dhuc
欒	vfd
欓	dfbf
欔	dbue
欕	drrk
欖	dswu
欗	dtaw
欘	dsei
欙	dwwf
欚	dvoi
欛	dmbb
欜	djbv
欝	ddwli
欞	dmbo
欟	dtgu
欠	no
次	imno
次	mmno
欢	eno
欣	hlno
欤	ymno
欥	ano
欦	onno
欧	skno
欨	prno
欩	srno
欪	uuno
欫	omno
欬	yono
欭	wkno
欮	tuno
欯	grno
欰	htno
欱	orno
欲	crno
欳	ybno
欴	iino
欵	pkno
欶	dlno
欷	kbno
欸	ikno
欹	krno
欺	tcno
欻	ffno
欼	eeeeo
欽	cno
款	gfno
欿	nxno
歀	dfno
歁	tvno
歂	ubno
歃	hxno
歄	bbno
歅	mgno
歆	yano
歇	avno
歈	onno
歉	tcno
歊	ybno
歋	huno
歌	mrno
歍	hfno
歎	tono
歏	tmno
歐	srno
歑	ydno
歒	ybno
歓	ogno
歔	ymno
歕	jcno
歖	grno
歗	lxno
歘	ffno
歙	omno
歚	trno
歛	oono
歜	wino
歝	wjno
歞	afno
歟	hcno
歠	ewno
歡	tgno
止	ylm
正	mylm
此	ymp
步	ylmh
武	mpylm
歧	ymje
歨	ylmo
歩	ylmh
歪	mfmym
歫	ymss
歬	ymhby
歭	ymgdi
歮	ymymm
歯	ymu'fd
歰	siymm
歱	ymhjg
歲	ymihh
歳	ymihf
歴	mddm
歵	ymqmc
歶	ypwlb
歷	mhdm
歸	hmsmb
歹	mn'i
死	mnp
歼	mnhj
歽	mnhml
歾	mnphh
歿	mnne
殀	mnhk
殁	mnhne
殂	mnbm
殃	mnlbk
殄	mnohh
殅	mnhqm
殆	mnir
殇	mnonh
殈	mnhbt
殉	mnpa
殊	mnhjd
残	mnij
殌	mnmvm
殍	mnbnd
殎	mnkoo
殏	mnije
殐	mndl
殑	mnjru
殒	mnrbo
殓	mnomm
殔	mnle
殕	mnytr
殖	mnjbm
殗	mnklu
殘	mnii
殙	mnhpa
殚	mncwj
殛	mnmem
殛	mnnem
殜	mnptd
殝	mnqkd
殞	mnrbc
殟	mnwot
殠	mnhuk
殡	mnjoc
殢	mnkpb
殣	mntlm
殤	mnoah
殥	mnjmc
殦	mnhaf
殧	mnyfu
殨	mnlmc
殩	mnyed
殪	mngbt
殫	mnrrj
殬	mnwlj
殭	mnmwm
殮	mnomo
殯	mnjmc
殰	mngwc
殱	mnjim
殲	mnoim
殳	hne
殴	skhne
段	hjhne
殶	yghne
殷	hshne
殸	ghhne
殹	skhne
殺	kchne
殻	gnhne
殼	gnhne
殽	kbhne
殾	jahne
殿	schne
毀	hghne
毁	hmhne
毂	gqhne
毃	ybhne
毄	jrhne
毅	yohne
毆	srhne
毇	hdhne
毈	hhsle
毉	semoo
毊	gehkb
毋	wjh
毌	wj
母	wy'i
毎	owj
每	owy'i
毐	gwj
毑	wypd
毒	qmwy'i
毓	oyyiu
比	pp
毕	ppj
毖	ppph
毗	wpp
毘	wpp
毙	ppmnp
毚	nrppi
毛	hqu
毜	huf
毝	huhhh
毞	pphqu
毟	fhhqu
毠	krhqu
毡	huyr
毢	humcw
毣	smhqu
毤	cuhqu
毥	hupa
毦	sjhqu
毧	huij
毨	huhgu
毩	hufd
毪	huihq
毫	yrbu
毬	huije
毭	mthqu
毮	qfhu
毯	huff
毰	huytr
毱	hupfd
毲	eeeeu
毳	huhuu
毴	hulmy
毵	ihhqu
毶	huikh
毷	auhqu
毸	huwp
毹	onhqu
毺	huomv
毻	kbhqu
毼	avhqu
毽	hunkq
毾	amhqu
毿	ihhqu
氀	lvhqu
氁	hutak
氂	jkmhu
氃	yghqu
氄	nbhqu
氅	fkhqu
氆	hutca
氇	hunwa
氈	ymhqu
氉	rdhqu
氊	huywm
氋	tohqu
氌	hunwa
氍	bghqu
氎	wmhqu
氏	hvp
氐	hpm
氐	hvpi
民	rvp
氒	hpj
氓	yvrvp
气	omn
氕	onl
氖	onnhs
気	onk
氘	onll
氙	onu
氚	onlll
氛	oncsh
氜	ona
氝	onob
氞	onmob
氟	onlln
氠	onlwl
氡	onhey
氢	onnom
氣	onfd
氤	onw'k
氥	onmcw
氦	onyvo
氧	ontq
氨	onjv
氩	onmtc
氪	onjru
氫	onmvm
氬	onmlm
氭	ondw
氮	onff
氯	onnme
氯	onvne
氰	onqmb
氱	onamh
氲	onabt
氳	onwot
水	e
氶	ne
氷	ie
永	ine
氹	ne
氺	ff
氻	eks
氼	eo
氽	oe
氾	esu
氿	ekn
汀	emn
汁	ej
求	ije
汃	ec
汄	eo
汅	emvs
汆	oe
汇	es
汈	esm
汉	ee
汊	ee'i
汋	epi
汌	elll
汍	ekni
汎	ehn'i
汏	ek
汐	en'i
汑	ehp
汒	eyv
汓	end
汔	eon
汕	eu
汖	ue
汗	emj
汘	ehj
汙	emd
汚	emjs
汛	enj
汜	eru
汝	ev
汞	me
江	em
池	epd
污	emms
汢	eg
汣	eno
汤	ensh
汥	eje
汦	ehvp
汧	emt
汨	ea
汩	ea
汪	emg
汫	ett
汬	tte
汭	eob
汮	epmm
汯	eki
汰	eki
汱	eik
汲	enhe
汳	ehe
汴	eyy
汵	eoin
汶	eyk
汷	ehe
汸	eyhs
汹	eu'k
決	edk
汻	eoj
汼	ehq
汽	eomn
汾	ecsh
汿	enin
沀	enin
沁	ep
沂	ehml
沃	ehk
沄	emmi
沅	emmu
沆	eyhn
沇	eihu
沈	elbu
沉	ebhn
沊	lue
沋	eiku
沌	epu
沍	emvm
沎	eop
沏	epsh
沐	ed
沑	eng
沒	ene
沓	ea
沔	emls
沕	ephh
沖	el
沗	hke
沗	mke
沘	epp
沙	efh
沚	eylm
沛	ejb
沜	elll
沝	ee
沞	emlb
沟	epi
沠	ehlo
没	ehne
沢	eso
沣	eqj
沤	es'k
沥	emks
沦	eop
沧	eosu
沨	ehn'k
沩	eiks
沪	eis
沫	edj
沬	ejd
沭	eid
沭	eijc
沮	ebm
沯	emr
沰	emr
沱	ejp
沲	eopd
河	emnr
沴	eohh
沵	enf
沶	emmf
沷	eikk
沸	elln
油	elw
沺	ew
治	eir
沼	eshr
沽	ejr
沾	eyr
沿	ecr
沿	ehnr
泀	esmr
況	erhu
泂	eb'r
泃	epr
泄	ept
泅	ew'o
泆	ehqo
泇	eksr
泈	ehey
泉	hae
泊	eha
泋	ejt
泌	eph
泍	edm
泎	eos
泏	euu
泐	enls
泑	evis
泒	ehvo
泓	eni
泔	et'm
法	egi
泖	ehhl
泗	ew'c
泘	ehfd
泙	emfj
泚	eymp
泛	ehio
泜	ehpm
泝	ehmy
泞	ejmn
泟	emym
泠	eoii
泡	epru
波	edhe
泣	eyt
泤	evio
泥	esp
泦	eskn
泧	eiv
注	eyg
泩	ehqm
泪	ebu
泫	eyvi
泬	ejc
泭	eodi
泮	efq
泯	ervp
泰	qke
泱	elbk
泲	elxh
泳	eine
泴	ebt
泵	mre
泶	fbe
泷	eikp
泸	eys
泹	eam
泺	ehvd
泻	ebym
泼	eive
泽	eeq
泾	enom
泿	eav
洀	ehby
洁	egr
洂	eylc
洃	ekf
洄	ew'r
洅	emgb
洆	enem
洇	ew'k
洈	enmu
洉	ehmr
洊	ekld
洋	etq
洌	emnn
洍	es'll
洎	ehbu
洏	emb'l
洐	ehon
洑	eoik
洒	emcw
洓	edb
洔	egdi
洕	ecb
洖	ervk
洗	ehgu
洘	ejks
洙	ehjd
洚	eheq
洛	eher
洜	hre
洝	ejv
洞	eb'mr
洟	ekn
洠	eihq
洡	eqd
洢	eosk
洣	efd
洤	eomg
津	elq
洦	ema
洧	ekb
洨	eyck
洩	elwp
洪	etc
洫	ehbt
洬	ehn'n
洭	es'mg
洮	elmo
洯	qhe
洰	ess
洱	esj
洲	eill
洳	evr
洴	ett
洵	epa
洶	epu'k
洷	emig
洸	efmu
洹	emam
洺	enir
活	ehjr
洼	egg
洽	eomr
派	ehhv
洿	ekms
浀	etw
流	eyiu
浂	etk
浃	ekt
浄	ensd
浅	eij
浆	lne
浇	ejpu
浈	eybo
浉	ellb
浊	elmi
测	ebon
浌	eoi
浍	eomi
济	eykl
浏	eykn
浐	eyth
浑	ebkq
浒	eivj
浓	ehbv
浔	esmi
浕	esoy
浖	ebdi
浗	eije
浘	eshu
浙	eqhl
浚	eice
浛	eoir
浜	eomc
浝	eiuh
浞	eryo
浟	eolk
浠	ekkb
浡	ejbd
浢	emrt
浣	ejmu
浤	ejki
浥	erau
浦	eijb
浧	erhg
浨	ejd
浩	ehgr
浪	eiav
浫	ebcj
浬	ewg
浭	emlk
浮	ebnd
浯	emmr
浰	ehdn
浱	emmv
浲	ehej
浳	eipb
浴	ecor
浵	ebyh
浶	ejhq
海	eowy
浸	esme
浹	ekoo
浺	epl
浻	eb'cr
浼	enau
浽	ebv
浾	eglc
浿	ebuc
涀	ebuu
涁	edhh
涂	eomd
涃	ew'd
涄	elws
涅	eag
涆	eamj
涇	emvm
消	efb
涉	eylh
涊	esip
涋	ejik
涌	enib
涍	ejkd
涎	enkm
涎	enkv
涏	enkg
涐	ehqi
涑	edl
涒	eskr
涓	erb
涔	euon
涕	ecnh
涖	eoyt
涗	ecru
涘	eiok
涙	emsk
涚	ecru
涛	eqki
涜	egbu
涝	etbs
涞	edt
涟	eykq
涠	ew'qs
涡	erob
涢	erbo
涣	enbk
涤	ehed
涥	eyrn
润	elsg
涧	elsa
涨	enpo
涩	esim
涪	eytr
涫	ejrr
涬	egtj
涭	ebbe
涮	esbn
涯	emgg
涰	eeee
涱	esmv
液	eyok
涳	ejcm
涴	ejnu
涵	eu'ne
涶	ehjm
涷	edw
涸	ew'jr
涹	ehdv
涺	esjr
涻	eomr
涼	eyrf
涽	ehpa
涾	eea
涿	emso
淀	ejmo
淁	eytv
淂	eami
淃	efqu
淄	evvw
淅	edhl
淆	ekkb
淇	etmc
淈	esuu
淉	ewd
淊	enhx
淋	edd
淌	efb'r
淍	eb'gr
淎	eqkq
淏	eamk
淐	eaa
淑	eyfe
淒	ejlv
淓	etys
淔	ejbm
淕	egcg
淖	eyaj
淗	epfd
淘	epou
淙	ejmf
淚	ehsk
淛	ehbn
淜	ebb
淝	ebau
淞	edci
淟	etbc
淠	ewml
淡	eff
淢	eirm
淣	ehxu
淤	eysy
淥	evne
淦	ec
淧	ejph
淨	ebsd
淩	egce
淪	eomb
淫	ebhg
淬	eyoj
淭	ehsd
淮	eog
淯	eyib
淰	eoip
深	ebcd
淲	eypu
淳	eyrd
淴	ephp
淵	elxl
淶	edoo
混	eapp
淸	eqmb
淹	eklu
淺	eii
添	ehkp
添	emkp
淼	eee
淽	etym
淾	ce
淿	ehab
渀	ekjt
渁	eee
渂	eayk
渃	etkr
渄	elmy
清	eqmb
渆	ettn
渇	eapp
済	eykl
渉	eylh
渊	elfl
渋	eymo
渌	enme
渍	eqmo
渎	ejnk
渏	ekmr
渐	ekql
渑	erlu
渒	ehwj
渓	ebqo
渔	enwm
渕	etkn
渖	ejll
渗	eikh
渘	enhd
渙	enbk
渚	ejka
減	eihr
渜	embk
渝	eomn
渞	ethu
渟	eyrn
渠	esd
渡	eite
渢	ehn'i
渣	edam
渤	ejds
渥	esmg
渦	ebb'r
渧	eybb
渨	ewmv
温	eabt
渪	ehlb
渫	eptd
測	ebcn
渭	ewb
渮	etmr
港	etcu
渰	eort
渱	elim
渲	ejmm
渳	ensj
渴	eapv
渵	etw
渶	etlk
渷	eycu
游	eysd
渹	epyr
渺	ebuh
渻	efhu
渼	etgk
渽	ejir
渾	ebjj
渿	edmf
湀	enok
湁	eqor
湂	errs
湃	ehqj
湄	eahu
湅	edw'f
湆	eyta
湇	eytb
湈	etmd
湉	ephr
湊	eqkk
湋	edmq
湌	eoiv
湍	eumb
湎	emw'l
湏	embc
湐	edha
湑	enob
湒	ersj
湓	ecst
湔	etbn
湕	enkq
湖	ejrb
湗	eggi
湘	edbu
湙	eyck
湚	elvu
湛	etmv
湜	eamo
湝	eppa
湞	eybc
湟	ehag
湠	eumf
湡	ewlb
湢	emrw
湣	erpa
湤	eysd
湥	ejck
湦	eahm
湧	enbs
湨	ebuk
湩	ehjg
湪	evno
湫	ehdf
湬	hfe
湭	etcw
湮	emwg
湯	eamh
湰	ehem
湱	eqjr
湲	ebme
湳	ejb'j
湴	ettc
湵	etgo
湶	ehae
湷	eqka
湸	eyru
湹	emwg
湺	eord
湻	eyra
湼	ehxm
湽	evmw
湾	eycn
湿	eatc
満	etub
溁	etbd
溂	edln
溃	elmo
溄	euhq
溅	eboj
溆	eode
溇	efdv
溈	eikf
溉	eaiu
溊	erse
溋	enst
溌	enop
溍	emia
溎	edgg
溏	eilr
源	emhf
溑	efbc
溒	egrv
溓	etxc
溔	etgf
溕	ebmo
準	egj
溗	ehdp
溘	egit
溙	eqke
溚	etor
溛	ejco
溜	ehhw
溝	ettb
溞	eeii
溟	ebac
溠	etqm
溡	eagi
溢	etct
溣	eoob
溤	esqf
溥	eibi
溦	euuk
溧	emwd
溨	ejid
溩	ehrf
溪	ebvk
溫	ewot
溬	etui
溭	ewce
溮	ehrb
溯	etub
溰	eumt
溱	eqkd
溲	ehxe
溳	erbc
溴	ehuk
溵	ehse
溶	ejcr
溷	ew'mo
溸	eqmf
溹	ejbf
溺	enmm
溻	easm
溼	emvg
溽	emvi
溾	ehui
溿	ewfq
滀	eyvw
滁	enld
滂	eybs
滃	ecim
滄	eoir
滅	eihf
滆	emrb
滇	ejbc
滈	eyrb
滉	eafu
滊	eond
滋	etvi
滌	eold
滍	eumi
滎	ffbe
滏	eckc
滐	enqd
滑	ebbb
滒	emrr
滓	ejyj
滔	ebhx
滕	bfqe
滖	eywv
滗	ehhu
滘	ebcr
滙	es'og
滚	eycv
滛	ebou
滜	ehaj
滝	eytu
滞	etjb
滟	eqju
滠	esje
满	etmb
滢	etbi
滣	emvr
滤	eypp
滥	elit
滦	eycd
滧	eykk
滨	ejoc
滩	eeog
滪	enno
滫	eolb
滬	ehsu
滭	ewtj
滮	eyuh
滯	ekpb
滰	eytu
滱	ejme
滲	eiih
滳	eycb
滴	eycb
滵	ejpu
滶	egsk
滷	eyw'i
滸	eyrj
滹	eypd
滺	eokp
滻	eyhm
滼	eddn
滽	eilb
滾	eycv
滿	etlb
漀	gee
漁	enwf
漂	emwf
漃	ejye
漄	eumg
漅	evvd
漆	edoe
漇	ehoo
漈	ebof
漉	eixp
漊	ellv
漋	enlm
漌	etlm
漍	ew'im
漎	ehoo
漏	esmb
漐	gie
漑	ehpu
漒	enii
漓	eyub
演	ejmc
漕	etwa
漖	ejdk
漗	ehwp
漘	emvb
漙	ejii
漚	es'rr
漛	efqe
漜	eddg
漝	esma
漞	ebbu
漟	efbg
漠	etak
漡	eoah
漢	etlo
漣	eyjj
漤	eddv
漥	ejcg
漦	jkme
漧	ejjn
漨	eyhj
漩	eyso
漪	ekhr
漫	eawe
漬	eqmc
漭	etit
漮	eile
漯	ewvf
漰	eubb
漱	edlo
漲	ensv
漳	eytj
漴	eujf
漵	eodk
漶	ellp
漷	eydl
漸	ejjl
漹	emyf
漺	ekkk
漻	esmh
漼	euog
漽	eseq
漾	etge
漿	vie
潀	ewlo
潁	pembc
潂	eutc
潃	ehob
潄	edlk
潅	eokg
潆	etbf
潇	etll
潈	ewlo
潉	euap
潊	eode
潋	eomk
潌	ejcg
潍	evmg
潎	efbk
潏	enhb
潐	eogf
潑	enoe
潒	enao
潓	ejip
潔	eqhf
潕	eotf
潖	emgu
潗	eogd
潘	ehdw
潙	ebhf
潚	elx
潛	emua
潜	eqoa
潝	eorm
潞	ermr
潟	ehxf
潠	eruc
潡	eydk
潢	etlc
潣	eank
潤	eang
潥	emwd
潦	ekcf
潧	ecwa
潨	ehwo
潩	ewtc
潪	eora
潫	efqf
潬	errj
潭	emwj
潮	ejjb
潯	esmi
潰	elmc
潱	egbt
潲	ehdb
潳	esja
潴	ekha
潵	etbk
潶	ewgf
潷	ehlq
潸	eddb
潹	eddd
潺	esnd
潻	ehde
潼	eytg
潽	etca
潾	efdq
潿	ew'dq
澀	esim
澁	eymm
澂	eugk
澃	hce
澄	enot
澅	elgm
澆	eggu
澇	effs
澈	eybk
澉	emjk
澉	enjk
澊	etwi
澋	eayf
澌	etcl
澍	egti
澎	egth
澏	erru
澐	embi
澑	emlw
澒	emmc
澓	ehoe
澔	ehar
澕	etmj
澖	eand
澗	eana
澘	edda
澙	ehxf
澚	ehbs
澛	enwa
澜	elsw
澝	ejpb
澞	eypk
澟	eywd
澠	erxu
澡	errd
澢	efbw
澣	ejjj
澤	ewlj
澥	enbq
澦	ennc
澧	etwt
澨	ehmo
澩	hbe
澪	embi
澫	etwb
澬	emoc
澭	eyvg
澮	eoma
澯	eyed
澰	eomo
澱	esce
澲	etcd
澳	ehbk
澴	ewlv
澵	eydl
澶	eywm
澷	eaws
澸	eirp
澹	encr
澺	eytp
澻	eyto
澼	esrj
澽	eypo
澾	eygq
澿	eddf
激	ehsk
濁	ewli
濂	eitc
濃	etwv
濄	eybb
濅	ejse
濆	ejtc
濇	egow
濈	erji
濉	ebug
濊	eymh
濋	eddo
濌	hgea
濍	etpp
濎	ebul
濏	emgh
濐	eaja
濑	edlo
濒	eyho
濓	eytc
濔	emfb
濕	eavf
濖	ewla
濗	etab
濘	ejpn
濙	efff
濚	effd
濛	etbo
濜	elmt
濝	etcf
濞	ehul
濟	eyx
濠	eyro
濡	embb
濢	esmj
濣	ejjj
濤	egni
濥	enic
濦	ebmp
濧	etgi
濨	etvp
濩	etoe
濪	eqbu
濫	esit
濬	eybu
濭	etgt
濮	eoto
濯	esmg
濰	evfg
濱	ejmc
濲	egde
濳	ehua
濴	effe
濵	ejac
濶	eanr
濷	eetb
濸	etor
濹	ewgg
濺	ebci
濻	enlc
濼	evid
濽	eqoc
濾	eypp
濿	emtb
瀀	embe
瀁	etov
瀂	enwa
瀃	ebch
瀄	ehal
瀅	effi
瀆	egwc
瀇	eitc
瀈	esmj
瀉	ejhf
瀊	ehet
瀋	ejhw
瀌	eipf
瀍	eiwg
瀎	etwi
瀏	ehcn
瀐	ejim
瀑	eate
瀒	edow
瀓	ehok
瀔	egde
瀕	eyhc
瀖	embg
瀗	ejqp
瀘	eypt
瀙	eydu
瀚	ejjm
瀛	eyrn
瀜	embi
瀝	emhm
瀞	eqbd
瀟	etlx
瀠	efff
瀡	enlb
瀢	eylc
瀣	eyem
瀤	eywv
瀥	esmb
瀦	emoa
瀧	eybp
瀨	edlc
瀩	ehuc
瀪	okhae
瀫	egfe
瀬	edlc
瀭	ejjn
瀮	embd
瀯	effr
瀰	enmb
瀱	ewln
瀲	eook
瀳	etif
瀴	ebcv
瀵	efdc
瀶	eslr
瀷	esmc
瀸	eoim
瀹	eomb
瀺	enri
瀻	ejic
瀼	eyrv
瀽	ejto
瀾	eanw
瀿	eokf
灀	embu
灁	eane
灂	ebwi
灃	eujt
灄	esjj
灅	ewwg
灆	etst
灇	etce
灈	ebug
灉	evug
灊	emub
灋	eifi
灌	etrg
灍	eano
灎	ettt
灏	eafo
灐	effc
灑	emmp
灒	ehuc
灓	vfe
灔	ettu
灕	eybg
灖	eicy
灗	elim
灘	etog
灙	efbf
灚	ehbu
灛	eanj
灜	eync
灝	eafc
灞	embb
灟	esei
灠	eswu
灡	etaw
灢	ejbv
灣	evfn
灤	evfd
灥	hehee
灦	eafc
灧	eutu
灨	eyjc
灩	eutt
灪	eddh
火	f
灭	mf
灮	fhu
灯	fmn
灰	kf
灱	fsh
灲	fln
灳	pf
灴	fm
灵	smf
灶	fg
灷	ft
灸	nof
灹	fhp
灺	fpd
灻	gf
灼	fpi
災	vvf
灾	jf
灿	fu
炀	fnsh
炁	muf
炂	fci
炃	cshf
炄	fng
炅	af
炆	fyk
炇	fok
炈	fhne
炉	fis
炊	fno
炋	fmf
炌	foll
炍	fhe
炎	ff
炏	ff
炐	fqj
炑	fd
炒	ffh
炓	fyj
炔	fdk
炕	fyhn
炖	fpu
炗	tf
炘	fhml
炙	bf
炚	af
炛	fop
炜	fqs
炝	fosu
炞	fyy
炟	fam
炠	fwl
炡	fmym
炢	fid
炣	fmnr
炤	fshr
炥	flln
炦	fikk
炧	fopd
炨	fjp
炩	foii
炪	fuu
炫	fyvi
炬	fss
炭	ukf
炭	umf
炮	fpru
炯	fb'r
炰	puf
炱	irf
炲	fir
炳	fmob
炴	flbk
炵	fhey
炶	fyr
炷	fyg
炸	fos
点	yrf
為	iknf
炻	fmr
炼	fkvd
炽	frc
炾	frhu
炿	fhby
烀	fhfd
烁	fhvd
烂	ftmm
烃	fnom
烄	fyck
烅	fhbt
烆	fhon
烇	fomg
烈	mnf
烉	nbf
烊	ftq
烋	odf
烌	fod
烍	fhgu
烎	mjf
烏	hryf
烐	fhby
烑	flmo
烒	fipm
烓	fgg
烔	fb'mr
烕	ihmf
烖	jif
烗	fyvo
烘	ftc
烙	fher
烚	fomr
烛	flmi
烜	fmam
烝	nemf
烞	fdy
烟	fw'k
烠	fkb
烡	ftc
烢	fjhp
烣	fmf
烤	fjks
烥	fs'll
烦	fmbo
烧	fjpu
烨	fopj
烩	fomi
烪	ftk
烫	ehf
烬	fsoy
热	qif
烮	mnf
烯	fkkb
烰	fbnd
烱	fb'cr
烲	qlf
烳	fijb
烴	fmvm
烵	ftpi
烶	fnkg
烷	fjmu
烸	fowy
烹	yrnf
烺	fiav
烻	fnkm
烼	fmso
烽	fhej
烾	ffg
烿	fbyh
焀	fcor
焁	rof
焂	okf
焃	fglc
焄	srf
焅	fhgr
焆	frb
焇	ffb
焈	huf
焉	mylf
焊	famj
焋	vgf
焌	fice
焍	fcnh
焎	qlf
焏	nef
焐	fmmr
焑	fw'd
焒	frhr
焒	frr
焓	foir
焔	fnla
焕	fnbk
焖	flsp
焗	fss'r
焙	fytr
焚	ddf
焛	anf
焜	fapp
焝	fhpa
焞	fyrd
焟	fta
焠	fyoj
無	otf
焢	fjcm
焣	sef
焤	ioif
焥	fjnu
焦	ogf
焧	fcip
焨	fab
焩	fbb
焪	fjcn
焫	ftob
焬	faph
焭	ffbhn
焮	fhlo
焯	fyaj
焰	fnhx
焱	fff
焲	fyok
焳	fog
焴	fyib
焵	fb'tu
然	bkf
焷	fhwj
焸	aaf
焹	fb'tv
焺	faht
焻	faa
焼	fjtu
焽	abf
焾	foip
焿	filo
煀	fsuu
煁	ftmv
煂	ftlj
煃	fkgg
煄	fhjg
煅	fhje
煆	frse
煇	fbjj
煈	fhn'i
煉	fdw'f
煊	fjmm
煋	fahm
煌	fhag
煍	fhdf
煎	tbnf
煏	fmrw
煐	ftlk
煑	jaf
煒	fdmq
煓	fumb
煔	ffyr
煕	suf
煖	fbme
煗	fmbk
煘	fihr
煙	fmwg
煚	asf
煛	buf
煜	fayt
煝	fahu
煞	nkf
煟	fwb
煠	fptd
煡	fnkq
煢	ffbnj
煣	fnhd
煤	ftmd
煥	fnbk
煦	arf
照	arf
煨	fwmv
煩	fmbc
煪	ftcw
煫	ftpo
煬	famh
煭	vnf
煮	jaf
煯	fppa
煰	frrr
煱	fbb'r
煲	odf
煳	fjrb
煴	fabt
煵	fjb'j
煶	famo
煷	fyru
煸	fhsb
煸	fisb
煹	fttb
煺	fyav
煻	filr
煼	fpuu
煽	fhsm
煽	fism
煾	fwkp
煿	fibi
熀	fafu
熁	fksb
熂	fond
熃	nsf
熄	fhup
熅	fwot
熆	fgit
熇	fyrb
熈	huf
熉	frbc
熊	ipf
熋	ipf
熌	fano
熍	fjrr
熎	fbou
熏	hgf
熐	fbac
熑	ftxc
熒	ffbf
熓	fhrf
熔	fjcr
熕	fmbc
熖	fbhx
熗	foir
熘	fhhw
熙	suf
熚	fwtj
熛	fmwf
熜	fhwp
熝	fixp
熞	fseg
熟	yif
熠	fsma
熡	fllv
熢	fyhj
熣	fuog
熤	fsmt
熥	fynb
熦	ffog
熧	hof
熨	sif
熩	fhsu
熪	fhdn
熫	fitf
熬	gkf
熬	qkf
熭	qjsmf
熮	fsmh
熯	ftlo
熰	fs'rr
熱	gif
熲	pfmbc
熳	fawe
熴	fuap
熵	fycb
熶	fase
熷	fcwa
熸	fmua
熹	grtf
熺	fgrr
熻	form
熼	fwtc
熽	flx
熾	fyia
熿	ftlc
燀	frrj
燁	ftmj
燂	fmwj
燃	fbkf
燄	nxff
燅	ggff
燆	fhkb
燇	ftwi
燈	fnot
燉	fydk
燊	fffd
燋	fogf
燌	fjtc
燍	ftcl
燎	fkcf
燏	fnhb
燐	ffdq
燑	fytg
燒	fggu
燓	ddf
燔	fhdw
燕	tlpf
燖	fsmi
燗	fanb
燘	fank
燙	ehf
燚	ffff
燛	ssf
燜	fanp
燝	fayf
燞	oof
營	ffbrr
燠	fhbk
燡	fwlj
燢	hbf
燣	fywd
燤	ftwb
燥	frrd
燦	fyed
燧	fyto
燨	ftgi
燩	fhsk
燪	ftpp
燫	fitc
燬	fhge
燭	fwli
燮	ffe
燯	fmbi
燰	fbbe
燱	fytp
燲	fksc
燳	farf
燴	foma
燵	fygq
燶	ftwv
燷	fywf
燸	fmbb
燹	mof
燺	fyrd
燻	fhgf
燼	flmt
燽	fgni
燾	gnmf
燿	fsmg
爀	fgcc
爁	fsit
爂	hbf
爃	fffd
爄	fmtb
爅	fwgg
爆	fate
爇	tgif
爈	fypp
爉	fvvv
爊	fipf
爋	fhfs
爌	fitc
爍	fvid
爎	fjkf
爏	fmhm
爐	fypt
爑	ftof
爒	bfkcf
爓	fanx
爔	ftgs
爕	fff
爖	fybp
爗	fatj
爘	fyev
爙	fyrv
爚	fomb
爛	fanw
爜	ftce
爝	fbwi
爞	flii
爟	ftrg
爠	fbug
爡	ftwi
爢	iyf
爣	ffbf
爤	ftaw
爥	fsei
爦	fswu
爧	fmbo
爨	hbddf
爩	fddh
爪	hlo
爬	hoau
爭	bsd
爮	hopru
爯	bgb
爰	bmke
爱	bbke
爲	bhnf
爳	bhfn
爴	wmhlo
爵	bwli
父	ck
爷	cksl
爸	ckau
爹	cknin
爺	cksjl
爻	kk
爼	kkbm
爽	kkkk
爾	mfb'k
爿	vlm
牀	vmd
牁	vmmnr
牂	vmtq
牃	vmptd
牄	vmoir
牅	vmilb
牆	vmgow
片	llml
片	llmn
版	llhe
版	lnhe
牉	llfq
牊	llshr
牋	llii
牌	llhwj
牌	lnhwj
牍	lnjnk
牎	llpkp
牏	llomn
牐	llhjx
牑	lnhsb
牒	llptd
牒	lnptd
牓	llybs
牔	lnibi
牕	lnhwp
牖	llhsb
牖	lnisb
牗	lnilb
牘	llgwc
牙	mvdh
牚	fbrmh
牛	hq
牝	hqp
牞	hqks
牟	ihq
牠	hqpd
牡	hqg
牢	jhq
牣	hqshi
牤	hqyv
牥	hqyhs
牦	hqhqu
牧	hqok
牨	hqyhn
物	hqphh
牪	hqhq
牫	hqi
牬	hqlxh
牭	hqw'c
牮	ophq
牯	hqjr
牰	hqlw
牱	hqmnr
牲	hqhqm
牳	hqwy'i
牴	hqhpm
牵	kbhq
牶	fqhq
牷	hqomg
牸	hqjnd
特	hqgdi
牺	hqmcw
牻	hqiuh
牼	hqmvm
牽	yvbq
牾	hqmmr
牿	hqhgr
犀	sehq
犁	hnhq
犂	hhhq
犃	hqytr
犄	hqkmr
犅	hqb'tu
犆	hqjbm
犇	hqhqq
犈	hqfqu
犉	hqyrd
犊	hqjnk
犋	hqbmc
犌	hqrse
犍	hqnkq
犎	gihq
犏	hqisb
犐	hqhdj
犑	hqbuk
犒	hqyrb
犓	hqpuu
犔	hqond
犕	hqthb
犖	ffbhq
犗	hqjqr
犘	ichq
犙	hqiih
犚	sihq
犛	jkmhq
犜	hqydk
犝	hqytg
犞	hqhkb
犟	nihq
犠	hqtgi
犡	hqmtb
犢	hqgwc
犣	hqvvv
犤	hqwlp
犥	hqipf
犦	hqate
犧	hqtgs
犨	oghq
犩	hihq
犪	hqtce
犫	oghq
犬	ik
犮	ikk
犯	khsu
犰	khkn
犱	khkni
犲	khdh
犳	khpi
犴	khmj
犵	khon
状	lmik
犷	khi
犸	khnvm
犹	khiku
犺	khyhn
犻	khjb
犼	khndu
犽	khmvh
犾	khik
犿	khyy
狀	vmik
狁	khihu
狂	khmg
狃	khng
狄	khf
狅	khhg
狆	khl
狇	khd
狈	khbo
狉	khmfm
狊	buik
狋	khmmf
狌	khhqm
狍	khpru
狎	khwl
狏	khopd
狐	khhvo
狑	khoii
狒	khlln
狓	khdhe
狔	khsp
狕	khvis
狖	khjc
狗	khpr
狘	khiv
狙	khbm
狚	kham
狛	khha
狜	khjr
狝	khnf
狞	khjmn
狟	khmam
狠	khav
狡	khyck
狢	khher
狣	khlmo
狤	khgr
狥	khpa
狦	khbtt
狧	khhjr
狨	khij
狩	khjdi
狪	khb'mr
狫	khjkp
独	khlmi
狭	khkt
狮	khllb
狯	khomi
狰	khnsd
狱	khivk
狲	khndf
狳	khomd
狴	khppg
狵	khiuh
狶	khkkb
狷	khrb
狸	khwg
狹	khkoo
狺	khymr
狻	khice
狼	khiav
狽	khbuc
狾	khqhl
狿	khnkm
猀	khefh
猁	khhdn
猂	khamj
猃	khomm
猄	khyrf
猅	khlmy
猆	lyik
猇	khypu
猈	khhwj
猉	khtmc
猊	khhxu
猋	ikikk
猌	doik
猍	khdoo
猎	khta
猏	khhsb
猐	khtgu
猑	khapp
猒	abik
猓	khwd
猔	khjmf
猕	khnnf
猖	khaa
猗	khkmr
猘	khhbn
猙	khbsd
猚	khog
猛	khndt
猜	khqmb
猝	khyoj
猞	khomr
猟	khfhn
猠	khtbc
猡	khwln
猢	khjrb
猣	khuce
猤	khnok
猥	khwmv
猦	khhn'i
猧	khbb'r
猨	khbme
猩	khahm
猪	khjka
猫	khtw
猬	khwb
猭	khvno
献	jbik
猯	khumb
猰	khqhk
猱	khnhd
猲	khapv
猳	khrse
猴	khonk
猵	khhsb
猶	khtcw
猷	twik
猸	khahu
猹	khdam
猺	khbou
猻	khndf
猼	khibi
猽	khbac
猾	khbbb
猿	khgrv
獀	khhxe
獁	khsqf
獂	khmhf
獃	utik
獄	khyrk
獅	khhrb
獆	khhaj
獇	khtui
獈	khtct
獉	khqkd
獊	khoir
獋	khhuj
獌	khawe
獍	khytu
獎	viik
獏	khtak
獐	khytj
獑	khjjl
獒	gkik
獒	qkik
獓	khgsk
獔	khhaj
獕	khuog
獖	khjtc
獗	khmto
獘	fkik
獙	khfbk
獚	khtlc
獛	khtco
獜	khfdq
獝	khnhb
獞	khytg
獟	khggu
獠	khkcf
獡	khhxf
獢	khhkb
獣	frik
獤	khydk
獥	khhsk
獦	khtav
獧	khwlv
獨	khwli
獩	khymh
獪	khoma
獫	khomo
獬	khnbq
獭	khdlo
獮	khmfb
獯	khhgf
獰	khjpn
獱	khjmc
獲	khtoe
獳	khmbb
獴	khtbo
獵	khvvv
獶	khmbe
獷	khitc
獸	rrik
獹	khypt
獺	khdlc
獻	ybik
獼	khnmb
獽	khyrv
獾	khtrg
獿	khmce
玀	khwlg
玁	khrrk
玂	khtjl
玃	khbue
玄	yvi
玅	yifh
玆	yiyvi
率	yioj
玈	yiohv
玉	mgi
玊	mgi
王	mg
玌	mgu
玍	og
玎	mgmn
玏	mgks
玐	mgc
玑	mghn
玒	mgm
玓	mgpi
玔	mglll
玕	mgmj
玖	mgno
玗	mgmd
玘	mgsu
玙	mgysm
玚	mgnsh
玛	mgnvm
玜	mgci
玝	mgoj
玞	mgqo
玟	mgyk
玠	mgoll
玡	mgmvh
玢	mgcsh
玣	mgyy
玤	mgqj
玥	mgb
玦	mgdk
玧	mgihu
玨	mgmg
玩	mgmmu
玪	mgoin
玫	mgok
玬	mgby
玭	mgpp
玮	mgqs
环	mgmf
现	mgbhu
玱	mgosu
玲	mgoii
玳	mgoip
玴	mgpt
玵	mgt'm
玶	mgmfj
玷	mgyr
玸	mgpru
玹	mgyvi
玺	nfmgi
玻	mgdhe
玼	mgymp
玽	mgpr
玾	mgwl
玿	mgshr
珀	mgha
珁	mgmvn
珂	mgmnr
珃	mggb
珄	mghqm
珅	mglwl
珆	mgir
珇	mgbm
珈	mgksr
珉	mgrvp
珊	mgbbm
珊	mgbt
珋	mghhl
珌	mgph
珍	mgohh
珎	mgnf
珏	mgmgi
珐	mggi
珑	mgikp
珒	mglq
珓	mgyck
珔	mgkld
珕	mgkss
珖	mgfmu
珗	mghgu
珘	mghby
珙	mgtc
珚	mgw'k
珛	mgkb
珜	mgtq
珝	mgsmm
珞	mgher
珟	mghn'n
珠	mghjd
珡	mgo
珢	mgav
珣	mgpa
珤	mgoju
珥	mgsj
珦	mghb'r
珧	mglmo
珨	mgomr
珩	mghon
珪	mggg
珫	mgyiu
珬	mgihm
班	mgilg
珮	mghn'b
珯	mgjkp
珰	mgfsm
珱	mgfv
珲	mgbkq
珳	mgykh
珴	mghqi
珵	mgrhg
珶	mgcnh
珷	mgmpm
珸	mgmmr
珹	mgihs
珺	mgskr
珻	mgowy
珼	mgbuc
珽	mgnkg
現	mgbuu
珿	mgryo
琀	mgoir
琁	mgono
琂	mgymr
球	mgije
琄	mgrb
琅	mgiav
理	mgwg
琇	mghds
琈	mgbnd
琉	mgyiu
琊	mgmhl
琋	mgkkb
琌	mguon
琍	mghdn
琎	mgytt
琏	mgykq
琐	mgfbo
琑	mgfb
琒	mghej
琓	mgjmu
琔	mgjmo
琕	mghwj
琖	mgii
琗	mgyoj
琘	mghpa
琙	mgirm
琚	mgsjr
琛	mgbcd
琜	mgdoo
琝	mgayk
琞	abmgi
琟	mgog
琠	mgtbc
琡	mgyfe
琢	mgmso
琣	mgytr
琤	mgbsd
琥	mgypn
琥	mgypu
琦	mgkmr
琧	mmmgi
琨	mgapp
琩	mgaa
琪	mgtmc
琫	mgqkq
琬	mgjnu
琭	mgvne
琮	mgjmf
琯	mgjrr
琰	mgff
琱	mgb'gr
琲	mglmy
琳	mgdd
琴	mgoin
琵	mgpp
琶	mgau
琷	mgtgu
琸	mgyaj
琹	mgd
琺	mgegi
琻	mgc
琼	mgyrf
琽	mgjka
琾	mgwol
琿	mgbjj
瑀	mghlb
瑁	mgabu
瑂	mgahu
瑃	mgqka
瑄	mgjmm
瑅	mgamo
瑆	mgahm
瑇	mgqmy
瑈	mgnhd
瑉	mgrpa
瑊	mgihr
瑋	mgdmq
瑌	mgmbk
瑍	mgnbk
瑎	mgppa
瑏	mgjch
瑐	mgtbn
瑑	mgvno
瑒	mgamh
瑓	mgdw'f
瑔	mghae
瑕	mgrse
瑖	mghje
瑗	mgbme
瑘	mgsjl
瑙	mgvvw
瑚	mgjrb
瑛	mgtlk
瑜	mgomn
瑝	mghag
瑞	mgumb
瑟	mgph
瑠	mghhw
瑡	mghrb
瑢	mgjcr
瑣	mgfbc
瑤	mgbou
瑥	mgwot
瑦	mghrf
瑧	mgqkd
瑨	mgmia
瑩	ffbmi
瑪	mgsqf
瑫	mgbhx
瑬	eumgi
瑭	mgilr
瑮	mgmwd
瑯	mgiil
瑰	mghui
瑱	mgjbc
瑲	mgoir
瑳	mgtqm
瑴	gghne
瑵	mgeii
瑶	mgbou
瑷	mgbbe
瑸	mgjoc
瑹	mgtod
瑺	mgfbb
瑻	mgwjc
瑼	mgjii
瑽	mghoo
瑾	mgtlm
瑿	semgi
璀	mguog
璁	mghwp
璂	mgtcg
璃	mgyub
璄	mgytu
璅	mgvvd
璆	mgsmh
璇	mgyso
璈	mggsk
璉	mgyjj
璊	mgtlb
璋	mgytj
璌	mgjmc
璍	mgtmj
璎	mgbov
璏	mgvmp
璐	mgrmr
璑	mgotf
璒	mgnot
璓	mgths
璔	mgcwa
璕	mgsmi
璖	mgesd
璗	ehmgi
璘	mgfdq
璙	mgkcf
璚	mgnhb
璛	mglx
璜	mgtlc
璝	mglmc
璞	mgtco
璟	mgayf
璠	mghdw
璡	mgyog
璢	mgmlw
璣	mgvii
璤	mgjip
璥	mgtrk
璦	mgbbe
璧	sjmgi
璨	mgyed
璩	mgypo
璪	mgrrd
璫	mgfbw
璬	mghsk
璭	mgybj
璮	mgywm
璯	mgoma
環	mgwlv
璱	mgmgh
璲	mgyto
璳	mghdc
璴	mgddo
璵	mghxc
璶	mglmt
璷	mgisk
璸	mgjmc
璹	mggni
璺	hbmgi
璻	mgsmj
璼	mgsmt
璽	mbmgi
璾	mgyx
璿	mgybu
瓀	mgmbb
瓁	mgtoe
瓂	mgtgt
瓃	mgwww
瓄	mggwc
瓅	mgvid
瓆	mghlc
瓇	mgmbe
瓈	mghhe
瓉	mgqoc
瓊	mgnbe
瓋	mgyyb
瓌	mgywv
瓍	mgnlb
瓎	mgdlc
瓏	mgybp
瓐	mgypt
瓑	mgmhm
瓒	mghuo
瓓	mganw
瓔	mgbcv
瓕	nbmgi
瓖	mgyrv
瓗	mguob
瓘	mgtrg
瓙	mggnf
瓚	mghuc
瓛	mgybk
瓜	hvio
瓝	hopi
瓞	hohqo
瓟	hopru
瓠	kshvo
瓡	gjhvo
瓢	mfhvo
瓣	yjhoj
瓤	yvhvo
瓥	holii
瓦	mvn'i
瓧	mnj
瓨	mmvn
瓩	mnhj
瓪	mnhe
瓫	cshn
瓬	ysmvn
瓭	lumvn
瓮	cimn
瓯	skmvn
瓰	mncsh
瓱	mnhqu
瓲	mnpu
瓳	jrmvn
瓴	oimvn
瓵	irmvn
瓶	ttmvn
瓷	iomvn
瓷	momvn
瓸	mnma
瓹	rbmvn
瓺	simvn
瓻	kbmvn
瓼	mnwg
瓽	fbrmn
瓾	hvmvn
瓿	yrmvn
甀	hmmvn
甁	yjyjn
甂	hbmvn
甃	hfmvn
甄	mgmvn
甅	mnmwg
甆	tvin
甇	ffbmn
甈	hdmvn
甉	tcmvn
甊	lvmvn
甋	ybmvn
甌	srmvn
甍	twln
甎	jimvn
甏	ghmvn
甐	fqmvn
甑	camvn
甒	ofmvn
甓	sjmvn
甔	nrmvn
甕	yvgn
甖	bcmvn
甗	ybmvn
甘	t'm
甙	ipt'm
甚	tmmv
甛	tmhjr
甜	hrt'm
甝	yut'm
甞	fbrtm
生	hqm
甠	ahqm
甡	hmhqm
產	ykmhm
産	yhhqm
甤	mohqm
甥	hmwks
甦	mkhqm
甧	hmb
用	b'q
甩	bqu
甪	hb'q
甫	ijb
甬	nib'q
甭	mfb'q
甮	phb'q
甯	jpb'q
田	w
由	lw
甲	wl
申	lwl
甴	lwlm
电	lwu
甶	hw
男	wks
甸	pw
甹	lwmvs
町	wmn
画	mu'w
甼	wmn
甽	wlll
甾	vvw
甿	wyv
畀	wml
畁	lwml
畂	wno
畃	llpi
畄	fw
畅	llnsh
畆	ywi
畇	wpmm
畈	whe
畉	wqo
畊	wtt
畋	wok
界	woll
畍	woll
畎	wik
畏	wmv
畐	mrw
畑	fw
畒	ywo
畓	ew
畔	wfq
畕	ww
畖	whvo
畗	yrw
畘	wgb
留	hhw
畚	ikw
畛	wohh
畜	yviw
畝	ywno
畞	jwno
畟	wche
畠	haw
畡	wyvo
畢	wtj
畣	orw
畤	wgdi
略	wher
畦	wgg
畧	wher
畨	fdw
畩	wyhv
番	hdw
畫	lgwm
畬	omdw
畭	womd
畮	wowy
畯	wice
異	wtc
畱	mllw
畲	ommw
畳	wbbm
畴	wqki
畵	lgu'w
當	fbrw
畷	weee
畸	wkmr
畹	wjnu
畺	mwmm
畻	wfqg
畼	wamh
畽	whjg
畾	www
畿	viw
疀	vwjlo
疁	wsmh
疂	wiom
疃	wytg
疄	wfdq
疅	wmwm
疆	ngmwm
疇	wgni
疈	mwilw
疉	wwwm
疊	wwwm
疋	nyo
疌	jlyo
疍	noam
疎	nmdl
疏	nmyiu
疐	jbwno
疑	pknio
疓	knhs
疔	kmn
疕	kp
疖	ksl
疗	knn
疘	km
疙	kon
疚	kno
疛	kdi
疜	kmy
疝	ku
疞	kmms
疟	ksm
疠	kms
疡	knsh
疢	kf
疣	kiku
疤	kau
疥	koll
疦	kdk
疧	khvp
疨	kmvh
疩	kknj
疪	kpp
疫	khne
疬	kmks
疭	koo
疮	kosu
疯	khn'k
疰	kyg
疱	kpru
疲	kdhe
疳	kt'm
疴	kmnr
疵	kymp
疶	kpt
疷	khpm
疸	kam
疹	kohh
疺	khio
疻	krc
疼	khey
疽	kbm
疾	kok
疿	klln
痀	kpr
痁	kyr
痂	kksr
痃	kyvi
痄	kos
病	kmob
痆	ksp
症	kmym
痈	kb'q
痉	knom
痊	komg
痋	klmi
痌	kb'mr
痍	kkn
痎	kyvo
痏	kkb
痐	kw'r
痑	knin
痒	ktq
痓	kmig
痔	kgdi
痕	kav
痖	kmtc
痗	kowy
痘	kmrt
痙	kmvm
痚	kjkd
痛	knib
痜	khdn
痝	kiuh
痞	kmfr
痟	kfb
痠	kice
痡	kijb
痢	khdn
痣	kgp
痤	koog
痥	kcru
痦	kmmr
痧	kefh
痨	ktbs
痩	klwe
痪	knbk
痫	klsd
痬	kaph
痭	kbb
痮	ksmv
痯	kjrr
痰	kff
痱	klmy
痲	kjcc
痳	kdd
痴	kokr
痵	khdd
痶	ktbc
痷	kklu
痸	khbn
痹	kwml
痺	khwj
痻	khpa
痼	kw'jr
痽	kog
痾	knlr
痿	khdv
瘀	kysy
瘁	kyoj
瘂	kmlm
瘃	kmso
瘄	kta
瘅	kcwj
瘆	kikh
瘇	khjg
瘈	kqhk
瘉	komn
瘊	konk
瘋	khn'i
瘌	kdln
瘍	kamh
瘎	ktmv
瘏	kjka
瘐	khxo
瘑	kbb'r
瘒	kbjj
瘓	knbk
瘔	ktjr
瘕	krse
瘖	kyta
瘗	kktg
瘘	kfdv
瘙	keii
瘚	ktuo
瘛	kqhp
瘜	khup
瘝	kwle
瘞	kkog
瘟	kabt
瘟	kwot
瘠	kfcb
瘡	koir
瘢	khye
瘣	khui
瘤	khhw
瘥	ktqm
瘦	khxe
瘧	kypm
瘨	kjbc
瘩	ktor
瘪	khup
瘫	keog
瘬	knsv
瘭	kmwf
瘮	kiih
瘯	kysk
瘰	kwvf
瘱	kkop
瘲	khoo
瘳	ksmh
瘴	kytj
瘵	kbof
瘶	kdlo
瘷	kdlk
瘸	kkrb
瘹	kcpi
瘺	ksmb
瘻	kllv
瘼	ktak
瘽	ktlm
瘾	knlp
瘿	kbov
癀	ktlc
癁	khoe
療	kkcf
癃	knlm
癄	kogf
癅	kmlw
癆	kffs
癇	kanb
癈	knoe
癉	krrj
癊	knli
癋	kmmp
癌	krru
癍	kmgg
癎	kana
癏	kwlv
癐	koma
癑	ktwv
癒	komp
癓	khok
癔	kytp
癕	kyvg
癖	ksrj
癗	kmbw
癘	ktwb
癙	khxv
癚	kncr
癛	kywd
癜	ksce
癝	kywf
癞	kdlo
癟	khub
癠	kyx
癡	kpko
癢	ktov
癣	knmq
癤	khal
癥	khok
癦	kwgg
癧	kmhm
癨	kmbg
癩	kdlc
癪	khdc
癫	kjco
癬	knfq
癭	kbcv
癮	knlp
癯	kbug
癰	kvug
癱	ktog
癲	kjcc
癳	kwwf
癴	kvfq
癵	kvfb
癷	nomj
癸	nomk
癹	nohne
発	nomkp
登	nomrt
發	nonhe
白	ha
百	ma
癿	hau
皀	hap
皁	haj
皂	hap
皃	hahu
的	hapi
皅	haau
皆	ppha
皇	hamg
皈	hahe
皉	haymp
皊	haoii
皋	hakj
皌	hadj
皍	hapsl
皎	hayck
皏	hatt
皐	haej
皑	hausu
皒	hahqi
皓	hahgr
皔	haamj
皕	mama
皖	hajmu
皗	hab'gr
皘	haqmb
皙	dlha
皚	haumt
皛	hahaa
皜	hayrb
皝	hgfmu
皞	hahaj
皟	haqmc
皠	hauog
皡	hahaj
皢	haggu
皣	hatmj
皤	hahdw
皥	hahuj
皦	hahsk
皧	habbe
皨	hahag
皩	hgafu
皪	havid
皫	haipf
皬	hambg
皭	habwi
皮	dhe
皯	demj
皰	depru
皱	nsdhe
皲	bqdhe
皳	iedhe
皴	iedhe
皵	tadhe
皶	dmdhe
皷	gtdhe
皸	bjdhe
皹	debjj
皺	pudhe
皻	ymdhe
皼	gtdhe
皽	ymdhe
皾	gcdhe
皿	bt
盀	ybt
盁	nsbt
盂	mdbt
盃	mfbt
盄	nlbt
盅	lbt
盆	csht
盇	kibt
盈	nsbt
盉	hdbt
益	tcbt
盋	ikbt
盌	nubt
盍	gibt
盎	lkbt
盏	ijbt
盐	gybt
监	libt
盒	orbt
盓	edbt
盔	kfbt
盕	enbt
盖	tgbt
盗	iobt
盘	hybt
盙	ibbt
盚	iebt
盛	isbt
盜	eobt
盝	vebt
盞	iibt
盟	abbt
盠	vobt
盡	lmfbt
盢	wkbt
監	sibt
盤	hebt
盥	hxbt
盦	oint
盧	ypwbt
盨	hcbt
盩	gkbt
盪	ehbt
盫	ormwt
盬	srbt
盭	vkbt
目	bu
盯	bumn
盰	bumj
盱	bumd
盲	yvbu
盳	buyv
直	jbmm
盵	buon
盶	bummu
盷	bupmm
相	dbu
盹	bupu
盺	buhml
盻	bucms
盼	bucsh
盽	buqj
盾	hjbu
盿	buyk
眀	bub
省	fhbu
眂	buhvp
眃	bummi
眄	bumls
眅	buhe
眆	buyhs
眇	bufh
眈	bulbu
眉	ahbu
眊	buhqu
看	hqbu
県	buvf
眍	bus'k
眎	bummf
眏	bulbk
眐	bumym
眑	buvis
眒	bulwl
眓	buiv
眔	wle
眕	buohh
眖	burhu
眗	bupr
眘	kcbu
眙	buir
眚	hmbu
眛	bujd
眜	budj
眝	bujmn
眞	pbuc
真	jbmc
眠	burvp
眡	buhpm
眢	nubu
眣	buhqo
眤	busp
眥	ypbu
眦	buymp
眧	bushr
眨	buhio
眩	buyvi
眪	bumob
眫	bufq
眬	buikp
眭	bugg
眮	bub'mr
眯	bufd
眰	bumig
眱	bukn
眲	busj
眳	bunir
眴	bupa
眵	bunin
眶	bus'mg
眷	fqbu
眸	buihq
眹	butk
眺	bulmo
眻	butq
眼	buav
眽	buhhv
眾	wlooo
眿	buine
着	tqbu
睁	bunsd
睂	olmbu
睃	buice
睄	bufb
睅	buamj
睆	bujmu
睇	bucnh
睈	burhg
睉	buoog
睊	burb
睋	buhqi
睌	bunau
睍	bubuu
睎	bukkb
睏	buw'd
睐	budt
睑	buomm
睒	buff
睓	butbc
睔	buomb
睕	bujnu
睖	bugce
睗	buaph
睘	wlmrv
睙	buhsk
睚	bumgg
睛	buqmb
睜	bubsd
睝	hhbu
睞	budoo
睟	buyoj
睠	bufqu
睡	buhjm
睢	buog
督	yebu
睤	buwml
睥	buhwj
睦	bugcg
睧	buhpa
睨	buhxu
睩	buvne
睪	wlgtj
睫	bujlo
睬	bubd
睭	bub'gr
睮	buomn
睯	rkbu
睰	butkr
睱	burse
睲	buahm
睳	bukgg
睴	bubjj
睵	bujir
睶	buqka
睷	bunkq
睸	buahu
睹	bujka
睺	buonk
睻	bujmm
睼	buamo
睽	bunok
睾	hwgtj
睿	ybmcu
瞀	nkbu
瞁	bubuk
瞂	huikk
瞃	buhju
瞄	butw
瞅	buhdf
瞆	bulmo
瞇	buyfd
瞈	bucim
瞉	guhne
瞊	builr
瞋	bujbc
瞌	bugit
瞍	buhxe
瞎	bujqr
瞏	wlgrv
瞐	bubuu
瞑	bubac
瞒	butmb
瞓	buyrl
瞔	buqmc
瞕	buytj
瞖	sebu
瞗	buhaf
瞘	bus'rr
瞙	butak
瞚	bujmc
瞛	buhoo
瞜	bullv
瞝	buyub
瞞	butlb
瞟	bumwf
瞠	bufbg
瞡	buqou
瞢	twlu
瞣	bullp
瞤	buang
瞥	fkbu
瞦	bugrr
瞧	buogf
瞨	butco
瞩	bushb
瞪	bunot
瞫	bumwj
瞬	bubbq
瞭	bukcf
瞮	buybk
瞯	buanb
瞰	bumjk
瞰	bunjk
瞱	butmj
瞲	bunhb
瞳	buytg
瞴	buotf
瞵	bufdq
瞶	bulmc
瞷	buana
瞸	butpd
瞹	bubbe
瞺	buoma
瞻	buncr
瞼	buomo
瞽	gebu
瞾	bujcm
瞿	buog
矀	buhok
矁	buhfp
矂	burrd
矃	bujpn
矄	buhgf
矅	busmg
矆	butoe
矇	butbo
矈	buhas
矉	bujmc
矊	buvfb
矋	bumtb
矌	buitc
矍	buoge
矎	bunbe
矏	buhus
矐	bumbg
矑	buypt
矒	butwu
矓	buybp
矔	butrg
矕	vfbu
矖	bummp
矗	jmjmm
矘	bufbf
矙	buank
矚	busei
矛	ninh
矜	nhoin
矝	nhoii
矞	nhb'cr
矟	nhfb
矠	nhta
矡	nhbue
矢	ok
矣	iok
矤	nok
知	okr
矦	nmok
矧	oknl
矨	okhk
矩	okss
矪	okhby
矫	okhkl
矬	okoog
短	okmrt
矮	okhdv
矯	okhkb
矰	okcwa
矱	oktoe
矲	okwlp
石	mr
矴	mrmn
矵	mrln
矶	mrhn
矷	mrnd
矸	mrmj
矹	mrmu
矺	mrhp
矻	mron
矼	mrm
矽	mrn'i
矾	mrhn'i
矿	mri
砀	mrnsh
码	mrnvm
砂	mrfh
砃	mrby
砄	mrdk
砅	mre
砆	mrqo
砇	mryk
砈	mrmsu
砉	qjmr
砊	mryhn
砋	mrylm
砌	mrpsh
砍	mrno
砎	mroll
砏	mrcsh
砐	mrnhe
砑	mrmvh
砒	mrpp
砓	mrhne
研	mrmt
砕	mrknj
砖	mrqni
砗	mrkq
砘	mrpu
砙	mrmvn
砚	mrbhu
砛	mroin
砜	mrhn'k
砝	mrgi
砞	mrdj
砟	mros
砠	mrbm
砡	mrmgi
砢	mrmnr
砣	mrjp
砤	mropd
砥	mrhpm
砥	mrhvi
砦	ypmr
砧	mryr
砨	mrhsn
砩	mrlln
砪	mrwy'i
砫	mryg
砬	mryt
砭	mrhio
砮	vemr
砯	mrie
砰	mrmfj
砱	mroii
砲	mrpru
砳	mrmr
破	mrdhe
砵	mrdm
砶	mrha
砷	mrlwl
砸	mrs'lb
砹	mrtk
砺	mrmms
砻	ipmr
砼	mrom
砽	mrb'q
砾	mrhvd
砿	mrii
础	mruu
硁	mrnom
硂	mromg
硃	mrhjd
硄	mrfmu
硅	mrgg
硆	mromr
硇	mrhw'k
硈	mrgr
硉	mrlq
硊	mrnmu
硋	mryvo
硌	mrher
硍	mrav
硎	mrmtn
硏	mrmjj
硐	mrb'mr
硑	mrtt
硒	mrmcw
硓	mrjkp
硔	mrtc
硕	mrmbo
硖	mrkt
硗	mrjpu
硘	mrw'r
硙	mrusu
硚	mrhkl
硛	mrylc
硜	mrmvm
硝	mrfb
硞	mrhgr
硟	mrnkm
硠	mriav
硡	mrjki
硢	mromd
硣	mrjkd
硤	mrkoo
硥	mriuh
硦	mrmgt
硧	mrnib
硨	mrjwj
硩	qlmr
硪	mrhqi
硫	mryiu
硬	mrmlk
硭	mrtyv
确	mrnb'g
确	mrnb'q
硯	mrbuu
硰	ehmr
硱	mrw'd
硲	mrcor
硳	mrglc
硴	mrtop
硵	mryw'k
硶	mruon
硷	mromm
硸	mrumj
硹	mrdci
硺	mrmso
硻	semr
硼	mrbb
硽	mrklu
硾	mrhjm
硿	mrjcm
碀	mrbsd
碁	tcmr
碂	mrjmf
碃	mrqmb
碄	mrdd
碅	mrw'hd
碆	eemr
碇	mrjmo
碈	mrhpa
碉	mrb'gr
碊	mrii
碋	mrumr
碌	mrnme
碌	mrvne
碍	mrami
碎	mryoj
碏	mrta
碐	mrgce
碑	mrhwj
碒	mrc
碓	mrog
碔	mrmpm
碕	mrkmr
碖	mromb
碗	mrjnu
碘	mrtbc
碙	mrb'tu
碚	mrytr
碛	mrqmo
碜	mrikh
碝	mrmbk
碞	rrrr
碟	mrptd
碠	mryrn
碡	mrqmy
碢	mrbb'r
碣	mrapv
碤	mrtlk
碥	mrhsb
碥	mrisb
碦	mrjhr
碧	mamr
碨	mrwmv
碩	mrmbc
碪	mrtmv
碫	mrhje
碬	mrrse
碭	mramh
碮	mramo
碯	mrvvw
碰	mrttc
碱	mrihr
碲	mrybb
碳	mrukf
碳	mrumf
碴	mrdam
碵	mrybc
碶	mrqhk
碷	mrhju
碸	mrhn'i
碹	mrjmm
確	mrobg
碻	mryrb
碼	mrsqf
碽	mrmbc
碾	mrstv
碿	mrsfb
磀	mrytu
磁	mrtvi
磂	mrhhw
磃	mrhyu
磄	mrilr
磅	mrybs
磆	mrbbb
磇	mrhwp
磈	mrhui
磉	mreed
磊	mrmrr
磋	mrtqm
磌	mrjbc
磍	mrjqr
磎	mrbvk
磏	mrtxc
磐	hemr
磑	mrumt
磒	mrrbc
磓	mryhr
磔	mrnqd
磕	mrgit
磖	mrsma
磗	mribi
磘	mrbou
磙	mrycv
磚	mrjii
磛	jlmr
磜	mrbof
磝	mrgsk
磞	mrubb
磟	mrsmh
磠	mryw'i
磡	mrtvs
磢	mrkkk
磣	mriih
磤	mrhse
磥	mrwvf
磦	mrmwf
磧	mrqmc
磨	icmr
磨	idmr
磩	mrihf
磪	mruog
磫	mrhoo
磬	gemr
磭	mrmvb
磮	mruob
磯	mrvii
磰	mrttr
磱	mrffs
磲	mresd
磳	mrcwa
磴	mrnot
磵	mrana
磶	mrhxf
磷	mrfdq
磸	mrtwk
磹	mrmwj
磺	mrtlc
磻	mrhdw
磼	mrogd
磽	mrggu
磾	mrrrj
磿	mhdr
礀	mranb
礁	mrogf
礂	mrgrr
礃	mrfbq
礄	mrhkb
礅	mrydk
礆	mromo
礇	mrhbk
礈	mryto
礉	mrhsk
礊	jemr
礋	mrwlj
礌	mrmbw
礍	mrtav
礎	mrddo
礏	mrtcd
礐	hbmr
礑	mrfbw
礒	mrtgi
礓	mrmwm
礔	mrsrj
礕	sjmr
礖	mrhxc
礗	mrjmc
礘	mravf
礙	mrpko
礚	mrtgt
礛	mrsit
礜	hcmr
礝	mrmbb
礞	mrtbo
礟	mrsfk
礠	mrtvp
礡	mrtii
礢	mrtov
礣	mrtwi
礤	mrtbf
礥	mrsec
礦	mritc
礧	mrwww
礨	wwwr
礩	mrhlc
礪	mrmtb
礫	mrvid
礬	ddkmr
礭	mrmbg
礮	mrsfk
礯	mrfff
礰	mrmhm
礱	ypmr
礲	mrybp
礳	mridr
礴	mrtei
礵	mrmbu
礶	mrtrg
礷	mrtst
礸	mrhuc
礹	mrrrk
示	mmf
礼	ifu
礽	ifnhs
社	ifg
礿	ifpi
祀	ifru
祁	ifnl
祂	ifpd
祃	ifnvm
祄	ifoll
祅	ifhk
祆	ifmk
祇	ifhvp
祈	ifhml
祉	ifylm
祊	ifyhs
祋	ifhne
祌	ifl
祍	ifhg
祎	ifqs
祏	ifmr
祐	ifkr
祑	ifhqo
祒	ifshr
祓	ifike
祓	ifikk
祔	ifodi
祕	ifph
祖	ifbm
祗	ifhpm
祗	ifhvi
祘	ifmmf
祙	ifjd
祚	ifos
祛	ifgi
祜	ifjr
祝	ifrhu
神	iflwl
祟	uummf
祠	ifsmr
祡	ypmmf
祢	ifnf
祣	ifohv
祤	ifsmm
祥	iftq
祦	ifrvk
祧	iflmo
票	mwmmf
祩	ifhjd
祪	ifnmu
祫	ifomr
祬	ifmig
祭	bommf
祮	ifgr
祯	ifybo
祰	ifhgr
祱	ifcru
祲	ifsme
祳	ifmmv
祴	ifit
祵	ifw'd
祶	ifcnh
祷	ifqki
祸	ifrob
祹	ifpou
祺	iftmc
祻	ifw'jr
祼	ifwd
祽	ifyoj
祾	ifgce
祿	ifvne
禀	ywrf
禁	ddmmf
禂	ifb'gr
禃	ifjbm
禄	ifnme
禅	ifcwj
禆	ifhwj
禇	ifjka
禈	ifbjj
禉	iftcw
禊	ifqhk
禋	ifmwg
禌	iftvi
禍	ifbb'r
禎	ifybc
福	ifmrw
禐	ifbme
禑	ifwlb
禒	ifvno
禓	ifamh
禔	ifamo
禕	ifdmq
禖	iftmd
禗	ifwp
禘	ifybb
禙	iflpb
禚	iftgf
禛	ifjbc
禜	ffbmf
禝	ifwce
禞	ifyrb
禟	ifilr
禠	ifhyu
禡	ifsqf
禢	ifasm
禣	ifibi
禤	ifwlm
禥	iftcg
禦	hlmmf
禧	ifgrr
禨	ifvii
禩	ifwtc
禪	ifrrj
禫	ifmwj
禬	ifoma
禭	ifyto
禮	iftwt
禯	iftwv
禰	ifmfb
禱	ifgni
禲	ifmtb
禳	ifyrv
禴	ifomb
禵	ifaoc
禶	ifhuc
禷	iffkc
禸	ib
禹	hlb'i
禺	wlb'i
离	yukb
禼	ywkb
禽	oyub
禾	hd
禿	hdhu
秀	hdnhs
私	hdi
秂	hdo
秃	hdhn
秄	hdnd
秅	hdhp
秆	hdmj
秇	hdkni
秈	hdu
秉	hdl
秊	hdhj
秋	hdf
秌	fhd
种	hdl
秎	hdcsh
秏	hdhqu
秐	hdmmi
科	hdyj
秒	hdfh
秓	hdje
秔	hdyhn
秕	hdpp
秖	hdhvp
秗	hdhk
秘	hdph
秙	hdjr
秚	hdfq
秛	hddhe
秜	hdsp
秝	hdhd
秞	hdlw
租	hdbm
秠	hdmfm
秡	hdikk
秢	hdoii
秣	hddj
秤	hdmfj
秥	hdyr
秦	qkhd
秧	hdlbk
秨	hdos
秩	hdhqo
秪	hdhpm
秫	hdid
秫	hdijc
秬	hdss
秭	hdlxh
秮	hdir
积	hdrc
称	hdnf
秱	hdb'mr
秲	hdgdi
秳	hdhjr
秴	hdomr
秵	hdw'k
秶	iohd
秷	hdmig
秸	hdgr
秹	hdohg
秺	hdjhp
移	hdnin
秼	hdhjd
秽	hdun'i
秾	hdhbv
秿	hdijb
稀	hdkkb
稁	yrbd
稂	hdiav
稃	hdbnd
稄	hdice
稅	hdcru
稆	hdrr
稇	hdw'd
稈	hdamj
稉	hdmlk
稊	hdcnh
程	hdrhg
程	hdrmg
稌	hdomd
稍	hdfb
税	hdcru
稏	hdmlm
稐	hdomb
稑	hdgcg
稒	hdw'jr
稓	hdta
稔	hdoip
稕	hdyrd
稖	hdytr
稗	hdhwj
稘	hdtmc
稙	hdjbm
稚	hdog
稛	hdw'hd
稜	hdgce
稝	hdbb
稞	hdwd
稟	ywrd
稠	hdb'gr
稡	hdyoj
稢	hdirm
稣	nmhd
稤	hdyrf
稥	hdfa
稦	hddmq
稧	hdqhk
稨	hdhsb
稩	hdwb
稪	hdoae
稫	hdmrw
稬	hdmbk
稭	hdppa
種	hdhjg
稯	hduce
稰	hdnob
稱	hdbgb
稲	hdbla
稳	hdnsp
稴	hdtxc
稵	hdtvi
稶	hdikm
稷	hdwce
稸	hdyvw
稹	hdjbc
稺	hdsyj
稻	hdbhx
稼	hdjmo
稽	hdiua
稾	yrbd
稿	hdyrb
穀	gdhne
穁	hdtsj
穂	hdjwp
穃	hdjcr
穄	hdbof
穅	hdile
穆	hdhah
穇	hdiih
穈	ichd
穉	hdseq
穊	hdaiu
穋	hdsmh
穌	nfhd
積	hdqmc
穎	pdmbc
穏	hdbsp
穐	hdnwu
穑	hdgcw
穒	hdhaf
穓	hdwtc
穔	hdtlc
穕	hdogd
穖	hdvii
穗	hdjip
穘	hdggu
穙	hdtco
穚	hdhkb
穛	hdogf
穜	hdytg
穝	hdase
穞	hdnwa
穟	hdyto
穠	hdtwv
穡	hdgow
穢	hdymh
穣	hdycv
穤	hdmbb
穥	hdhxc
穦	hdjmc
穧	hdyx
穨	hulmc
穩	hdbmp
穪	hdmfb
穫	hdtoe
穬	hditc
穭	hdnwa
穮	hdipf
穯	hdgrw
穰	hdyrv
穱	hdbwi
穲	hdmmp
穳	hdhuc
穴	jc
穵	jcn
究	jckn
穷	jcks
穸	jcn'i
穹	jcn
空	jcm
穻	jcmd
穼	jcd
穽	jctt
穾	jchk
穿	jcmvh
窀	jcpu
突	jcik
窂	jchq
窃	jcpsh
窄	jcos
窅	jcbu
窆	jchio
窇	jcpru
窈	jcvis
窉	jcmob
窊	jchvo
窋	jcuu
窌	jchhl
窍	jcmms
窎	jcpym
窏	jcemd
窐	jcgg
窑	jcoju
窒	jcmig
窓	jcip
窔	jcyck
窕	jclmo
窖	jchgr
窗	jchw'e
窗	jchw'k
窘	jcskr
窙	jcjkd
窚	jcihs
窛	jcmuv
窜	jcll
窝	jcrob
窞	jcnhx
窟	jcsuu
窠	jcwd
窡	jceee
窢	jcirm
窣	jcyoj
窤	jcapp
窥	jcqou
窦	jcjnk
窧	jcyaj
窨	jcyta
窩	jcbb'r
窪	jcegg
窫	jcqhk
窬	jcomn
窭	jcfdv
窮	jchhn
窯	jctgf
窰	jcbou
窱	jcold
窲	jcfdj
窳	jchoo
窴	jcjbc
窵	jchaf
窶	jcllv
窷	jcsjl
窸	jchdp
窹	jcvmr
窺	jcqou
窻	jchwp
窼	jcvvd
窽	jcpko
窾	jcgfo
窿	jcnlm
竀	jcmmu
竁	jchuu
竂	jckcf
竃	jcgwu
竄	jchxv
竅	jchsk
竆	jchhr
竇	jcgwc
竈	jcgru
竉	jcybp
竊	jchdb
立	yt
竌	ythn
竍	ytj
竎	ytt
竏	ythj
竐	ythne
竑	ytki
竒	ytnr
竓	ythqu
竔	ytht
竕	ytcsh
竖	leyt
竗	ytfh
竘	ytpr
站	ytyr
竚	ytjmn
竛	ytoii
竜	ytwu
竝	ytyt
竞	ytrhu
竟	ytahu
章	ytaj
竡	ytma
竢	ytiok
竣	ytice
竤	ytjki
童	ytwg
竦	ytdl
竧	ythxh
竨	ytyaj
竩	ytjbm
竪	seyt
竫	ytbsd
竬	ythlb
竭	ytapv
竮	ytstt
端	ytumb
竰	ytmwg
竱	ytjii
竲	ytcwa
竳	ytnot
竴	yttwi
竵	ytmrb
競	yuytu
竷	yjhee
竸	yuytu
竹	h
竺	hmm
竻	hks
竼	hhn'i
竽	hmd
竾	hpd
竿	hmj
笀	hyv
笁	hm
笂	hkni
笃	hnvm
笄	hmt
笅	hkk
笆	hau
笇	hyy
笈	hnhe
笉	hpmm
笊	hhlo
笋	hsk
笌	hmvh
笍	hob
笎	hmmu
笏	hphh
笐	hyhn
笑	hhk
笒	hoin
笓	hpp
笔	hhqu
笕	hbhu
笖	hvio
笗	hhey
笘	hyr
笙	hhqm
笚	hwl
笛	hlw
笜	huu
笝	hw'e
笞	hir
笟	hhvo
笠	hyt
笡	hbm
笢	hrvp
笣	hpru
笤	hshr
笥	hsmr
符	hodi
笧	hbt
笨	hdm
笩	hoip
笪	ham
笫	hlxh
第	hnlh
笭	hoii
笮	hos
笯	hve
笰	hlln
笱	hpr
笲	hit
笳	hksr
笴	hmnr
笵	hesu
笶	hok
笷	hhhl
笸	hs'r
笹	hpt
笺	hij
笻	hmnl
笼	hikp
笽	hbt
笾	hyks
笿	hher
筀	hgg
筁	htw
筂	hepd
筃	hw'k
筄	hlmo
筅	hhgu
筆	hlq
筇	hmnl
筇	hmsl
筈	hhjr
等	hgdi
筊	hyck
筋	hbks
筌	homg
筍	hpa
筎	hvr
筏	hoi
筐	hs'mg
筑	hmhn
筒	hb'mr
筓	hmjj
答	homr
筕	hhon
策	hdb
筗	hol
筘	hqr
筙	hqd
筚	hppj
筛	hllb
筜	hfsm
筝	hnsd
筞	hjd
筟	hbnd
筠	hgpm
筡	homd
筢	hqau
筣	hhdn
筤	hiav
筥	hrhr
筦	hjmu
筧	hbuu
筨	hoir
筩	hnib
筪	hs'wl
筫	hbuc
筬	hihs
筭	hmgt
筮	hmoo
筯	hbms
筰	hoos
筱	holk
筲	hfb
筳	hnkg
筴	hkoo
筵	hnkm
筵	hnkv
筶	hhgr
筷	hpdk
筸	hamj
筹	hqki
筺	hsmi
筻	hmlk
筼	hrbo
筽	hrmk
签	homm
筿	hhed
简	hlsa
箁	hytr
箂	hdoo
箃	hsje
箄	hhwj
箅	hwml
箆	hbop
箇	hw'jr
箈	heir
箉	hqrs
箊	hysy
箋	hii
箌	hmgn
箍	hqs'b
箎	hypu
箏	hbsd
箐	hqmb
箑	hjlo
箒	hsmb
箓	hvne
箔	heha
箕	htmc
箖	hdd
算	hbut
箘	hw'hd
箙	hbse
箚	horn
箛	hndo
箜	hjcm
箝	hqt'm
箞	hfqu
箟	happ
箠	hhjm
管	hjrr
箢	hjnu
箣	hdbn
箤	hyoj
箥	hede
箦	hqmo
箧	hs'kt
箨	hqeq
箩	hwln
箪	hcwj
箫	hlll
箬	htkr
箭	htbn
箮	hjmm
箯	homk
箰	hpad
箱	hdbu
箲	hehu
箳	hstt
箴	hihr
箵	hfhu
箶	hjrb
箷	hysd
箸	hjka
箹	hvfi
箺	hqka
箻	hhoq
箼	hsmg
箽	hhjg
箾	hfbn
箿	hrsj
節	hail
篁	hhag
篂	hahm
篃	hahu
範	hjju
篅	humb
篆	hvno
篇	hhsb
篇	hisb
篈	hggi
築	hmnd
篊	hetc
篋	hs'ko
篌	honk
篍	hhdf
篎	hbuh
篏	htmo
篐	hds'b
篑	hlmo
篒	hoiv
篓	hfdv
篔	hrbc
篕	hgit
篖	hilr
篗	hoge
篘	hpuu
篙	hyrb
篚	hs'ly
篛	hnmm
篜	hnef
篝	httb
篞	heag
篟	hoqb
篠	hold
篡	hbui
篢	hmbc
篣	hybs
篤	hsqf
篥	hmwd
篦	hhwp
篧	hobg
篨	hnld
篩	hhrb
篪	hhyn
篪	hhyu
篫	hmnq
篬	hoir
篭	hytu
篮	hlit
篯	hopj
篰	hyrl
篱	hyub
篲	hqjm
篳	hwtj
篴	hymo
篵	hhoo
篶	hmyf
篷	hyhj
篸	hiih
篹	hbuu
篺	hqhj
篻	hmwf
篼	hhvu
篽	hhol
篾	hwli
篿	hjii
簀	hqmc
簁	hhoo
簂	hw'im
簃	hhdn
簄	hhsu
簅	hyhm
簆	hjmk
簇	hysk
簈	hsyj
簉	hyhr
簊	htcg
簋	havt
簌	hdlo
簍	hllv
簎	hqta
簏	hixp
簐	hjjo
簑	hywv
簒	hbui
簓	hbrh
簔	hywv
簕	htjs
簖	hvdl
簗	heid
簘	hlll
簙	hjii
簚	hwlb
簛	htcl
簜	heah
簝	hkcf
簞	hrrj
簟	hmwj
簠	hibt
簡	hana
簢	hank
簣	hlmc
簤	hwlc
簥	hhkb
簦	hnot
簧	htlc
簨	hruc
簩	hffs
簪	hmua
簫	hlx
簬	hrmr
簭	hgcr
簮	hqoa
簯	hdtc
簰	hllj
簱	hysc
簲	hbhj
簳	hjjj
簴	hypc
簵	hjjr
簶	hife
簷	hncr
簸	htce
簹	hfbw
簺	hjtg
簻	hybb
簼	hqtb
簽	homo
簾	hitc
簿	heii
籀	hqhw
籁	hdlo
籂	hoib
籃	hsit
籄	hs'lc
籅	hhxc
籆	htoe
籇	hyro
籈	hmgn
籉	hgrg
籊	hsmg
籋	hmfb
籌	hgni
籍	hqda
籎	hpko
籏	hysc
籐	hbfe
籑	hbuv
籒	hqmw
籓	hehw
籔	hlvk
籕	hdhw
籖	hjim
籗	hmbg
籘	hbff
籙	hcve
籚	hypt
籛	hcii
籜	hqwj
籝	hynv
籞	hhlf
籟	hdlc
籠	hybp
籡	hqoo
籢	hook
籣	hanw
籤	hoim
籥	homb
籦	hchg
籧	hyyo
籨	hooo
籩	hyhs
籪	hvil
籫	hhuc
籬	hybg
籭	hmmp
籮	hwlg
籯	hync
籰	hbue
籱	hmbg
籲	hobc
米	fd
籴	ofd
籵	fdj
籶	fdhn
籷	fdhp
籸	fdnj
籹	fdv
籺	fdon
类	fdk
籼	fdu
籽	fdnd
籾	fdshi
籿	fddi
粀	fdjk
粁	fdhj
粂	nofd
粃	fdpp
粄	fdhe
粅	fdphh
粆	fdfh
粇	fdyhn
粈	fdng
粉	fdcsh
粊	ppfd
粋	fdknj
粌	fdnl
粍	fdhqu
粎	fdso
粏	fdki
粐	fdis
粑	fdau
粒	fdyt
粓	fdt'm
粔	fdss
粕	fdha
粖	fddj
粗	fdbm
粘	fdyr
粙	fdlw
粚	fdopd
粛	llfl
粜	uufd
粝	fdmms
粞	fdmcw
粟	mwfd
粠	fdtc
粡	fdb'mr
粢	iofd
粢	mofd
粣	fdbt
粤	hwmvs
粥	nfdn
粦	fdniq
粧	fdig
粨	fdma
粩	fdjkp
粪	fdtc
粫	fdmb'l
粬	fdtw
粭	fdomr
粮	fdiav
粯	fdbuu
粰	fdbnd
粱	ecfd
粱	eifd
粲	yefd
粳	fdmlk
粴	fdwg
粵	hwmvs
粶	fdvne
粷	fdpfd
粸	fdtmc
粹	fdyoj
粺	fdhwj
粻	fdsmv
粼	fqvv
粽	fdjmf
精	fdqmb
粿	fdwd
糀	fdtop
糁	fdikh
糂	fdtmv
糃	fdamh
糄	fdhsb
糅	fdnhd
糆	fdmw'l
糇	fdonk
糈	fdnob
糉	fduce
糊	fdjrb
糋	fdtbn
糌	fdhoa
糌	fdhya
糍	fdtvi
糎	fdmwg
糏	fdsfb
糐	fdibi
糑	fdnmm
糒	fdthb
糓	gdhne
糔	fdeii
糕	fdtgf
糖	fdilr
糗	fdhuk
糘	fdjmo
糙	fdyhr
糚	fdtvg
糛	fdfbg
糜	icfd
糜	idfd
糝	fdiih
糞	fdwtc
糟	fdtwa
糠	fdile
糡	fdytu
糢	fdtak
糣	fdmua
糤	fdtbk
糥	fdmbb
糦	fdgrr
糧	fdamg
糨	fdnii
糨	fdnri
糩	fdoma
糪	sjfd
糫	fdwlv
糬	fdwla
糭	fduce
糮	fdsit
糯	fdmbb
糰	fdw'ji
糱	ujfd
糲	fdmtb
糳	tefd
糴	odsmg
糵	tjfd
糶	udsmg
糷	fdtaw
糸	vif
糹	vif
糺	vfu
系	hvif
糼	vfks
糽	vfmn
糾	vfvl
糿	vfsh
紀	vfsu
紁	vfik
紂	vfdi
紃	vflll
約	vfpi
紅	vfm
紆	vfmd
紇	vfon
紈	vfkni
紉	vfshi
紊	ykvif
紋	vfyk
紌	vfiku
納	vfob
紎	vfik
紏	vfyj
紐	vfng
紑	vfmf
紒	vfoll
紓	vfnin
純	vfpu
紕	vfpp
紖	vfnl
紗	vffh
紘	vfki
紙	vfhvp
級	vfnhe
紛	vfcsh
紜	vfmmi
紝	vfhg
紞	vflbu
紟	vfoin
素	qmvif
紡	vfyhs
索	jbvif
紣	vfknj
紤	vfhml
紥	quvif
紦	vfau
紧	levif
紨	vfodi
紩	vfhqo
紪	vfymp
紫	ypvif
紬	vflw
紭	vfni
紮	duvif
累	wvif
細	vfw
紱	vfikk
紲	vfpt
紳	vflwl
紴	vfdhe
紵	vfjmn
紶	vfgi
紷	vfoii
紸	vfyg
紹	vfshr
紺	vft'm
紻	vflbk
紼	vflln
紽	vfjp
紾	vfohh
紿	vfir
絀	vfuu
絁	vfopd
終	vfhey
絃	vfyvi
組	vfbm
絅	vfb'r
絆	vffq
絇	vfpr
絈	vfha
絉	vfijc
絊	vfdm
絋	vfii
経	vfeg
絍	vfohg
絎	vfhon
絏	vflwp
結	vfgr
絑	vfhjd
絒	vfill
絓	vfgg
絔	vfma
絕	vfshu
絖	vffmu
絗	vfw'r
絘	vfmmo
絙	vfmam
絚	vfmbm
絛	olof
絜	qhvif
絝	vfkms
絞	vfyck
絟	vfomg
絠	vfkb
絡	vfher
絢	vfpa
絣	vftt
絤	vfmcw
絥	vfoik
給	vfomr
絧	vfb'mr
絨	vfij
絩	vflmo
絪	vfw'k
絫	iiif
絬	vfhjr
絭	fqvif
絮	vrvif
絯	vfyvo
絰	vfmig
統	vfyiu
絲	vfvif
絳	vfheq
絴	vftq
絵	vfomi
絶	vfnau
絷	qivif
絸	vfbuu
絹	vfrb
絺	vfkkb
絻	vfnau
絼	vfbsh
絽	vfrhr
絾	vfihs
絿	vfije
綀	vfdl
綁	vfqjl
綂	vfyru
綃	vffb
綄	vfjmu
綅	vfsme
綆	vfmlk
綇	vfmcw
綈	vfcnh
綉	vfhds
綊	vfkoo
綋	vfjki
綌	vfcor
綍	vfjbd
綎	vfnkg
綏	vfbv
綐	vfcru
綑	vfw'd
綒	vfbnd
經	vfmvm
綔	kshvf
綕	vfgp
綖	vfnkm
綗	vfb'cr
綘	vfhej
継	vfvfd
続	vfgbu
綛	vfsip
綜	vfjmf
綝	vfdd
綞	vfhjm
綟	vfhsk
綠	vfvne
綡	vfyrf
綢	vfb'gr
綣	vffqu
綤	slvif
綥	vfwml
綦	tcvif
綧	vfyrd
綨	vftmc
綩	vfjnu
綪	vfqmb
綬	vfbbe
維	vfog
綮	hkvif
綮	ikvif
綯	vfpou
綰	vfjrr
綱	vfb'tu
網	vfb'tv
綳	vfbb
綴	vfeee
綵	vfbd
綶	vfwd
綷	vfyoj
綸	vfomb
綹	vfhor
綺	vfkmr
綻	vfjmo
綼	vfhwj
綽	vfyaj
綾	vfgce
綿	vfhab
緀	vfjlv
緁	vfjlo
緂	vfff
緃	vfooo
緄	vfapp
緅	vfsje
緆	vfaph
緇	vfvvw
緈	vfgtj
緉	vfmlb
緊	sevif
緋	vflmy
緌	vfhdv
緍	vfhpa
緎	vfirm
総	vfcip
緐	oyhvf
緑	vfnme
緒	vfjka
緓	vftlk
緔	vffb'r
緕	vfykl
緖	vfjka
緗	vfdbu
緘	vfihr
緙	vftlj
線	vfhae
緛	vfmbk
緜	hbhvf
緝	vfrsj
緞	vfhje
緟	vfhjg
締	vfybb
緡	vfrpa
緢	vftw
緣	vfvno
緤	vfptd
緥	vford
緦	vfwp
緧	vftcw
編	vfhsb
緩	vfbme
緪	vfpmm
緫	vfpkp
緬	vfmw'l
緭	vfwb
緮	vfoae
緯	vfdmq
緰	vfomn
緱	vfonk
緲	vfbuh
緳	iqhf
練	vfdw'f
緵	vfuce
緶	vfomk
緷	vfbjj
緸	vfmwg
緹	vfamo
緺	vfbb'r
緻	vfmgk
緼	vfabt
緽	vfybc
緾	vfmwg
緿	vfirp
縀	vfrse
縁	vfnmo
縂	vfcrp
縃	vfnob
縄	vfwlu
縅	vfihv
縆	vfpmm
縇	vfjmm
縈	ffbvf
縉	vfmia
縊	vftct
縋	vfyhr
縌	vfytu
縍	vfybs
縎	vfbbb
縏	hevif
縐	vfpuu
縑	vftxc
縒	vftqm
縓	vfmhf
縔	vfeed
縕	vfwot
縖	vfjqr
縗	vfywv
縘	vfbvk
縙	vftsj
縚	vfbhx
縛	vfibi
縜	vfrbc
縝	vfjbc
縞	vfyrb
縟	vfmvi
縠	gfhne
縡	vfjyj
縢	bfqf
縣	bfhvf
縤	vfqmf
縥	vfqkd
縦	vfhoo
縧	vfold
縨	vfafu
縩	vfbof
縪	vfwtj
縫	vfyhj
縬	vfihf
縭	vfyub
縮	vfjoa
縯	vfjmc
縰	vfhoo
縱	vfhoo
縲	vfwvf
縳	vfjii
縴	vfyvq
縵	vfawe
縶	givif
縷	vfllv
縸	vftak
縹	vfmwf
縺	vfyjj
縻	icvif
縼	vfyso
總	vfhwp
績	vfqmc
縿	vfiih
繀	vfuog
繁	okvif
繂	vfyij
繃	vfubb
繄	sevif
繅	vfvvd
繆	vfsmh
繇	buhvf
繈	vfnii
繉	vfbuo
繊	vfjic
繋	jevif
繌	vfhce
繍	vflll
繎	vfbkf
繏	vfruc
繐	vfjip
繑	vfhkb
繒	vfcwa
繓	vfase
織	vfyia
繕	vftgr
繖	vftbk
繗	vffdq
繘	vfnhb
繙	vfhdw
繚	vfkcf
繛	qfyaj
繜	vftwi
繝	vfanb
繞	vfggu
繟	vfrrj
繠	pppf
繡	vflx
繢	vflmc
繣	vflgm
繤	takf
繥	vfgrr
繦	vfnri
繧	vfmbi
繨	vfygq
繩	vfrxu
繪	vfoma
繫	jevif
繬	vfgow
繭	tb'li
繮	vfmwm
繯	vfwlv
繰	vfrrd
繱	vftpp
繲	vfnbq
繳	vfhsk
繴	sjvif
繵	vfywm
繶	vfytp
繷	vftwv
繸	vfyto
繹	vfwlj
繺	vfnkf
繻	vfmbb
繼	vfvvi
繽	vfjmc
繾	vfylr
繿	vfsmt
纀	vfoto
纁	vfhgf
纂	hbuf
纃	vfyx
纄	vftyj
纅	vfvid
纆	vfwgg
纇	ffmbc
纈	vfgrc
纉	vfqoc
纊	vfitc
纋	vfmbe
續	vfgwc
纍	wwwf
纎	vfjim
纏	vfiwg
纐	vfykc
纑	vfypt
纒	vfmwg
纓	vfbcv
纔	vfnri
纕	vfyrv
纖	vfoim
纗	vfuob
纘	vfhuc
纙	vfwlg
纚	vfmmp
纛	qmwyf
纜	vfswu
纝	vfwwf
纞	vfvfp
纠	vmvl
纡	vmmd
红	vmm
纣	vmdi
纤	vmhj
纥	vmon
约	vmpi
级	vmnhe
纨	vmkni
纩	vmi
纪	vmsu
纫	vmshi
纬	vmqs
纭	vmmmi
纮	vmki
纯	vmpu
纰	vmpp
纱	vmfh
纲	vmb'k
纳	vmob
纴	vmhg
纵	vmoo
纶	vmop
纷	vmcsh
纸	vmhvp
纹	vmyk
纺	vmyhs
纻	vmjm
纼	vmnl
纽	vmng
纾	vmnin
线	vmij
绀	vmt'm
绁	vmpt
绂	vmike
练	vmkvd
组	vmbm
绅	vmlwl
细	vmw
织	vmrc
终	vmhey
绉	vmnsm
绉	vmns'm
绊	vmfq
绋	vmlln
绌	vmuu
绍	vmshr
绎	vmeq
经	vmnom
绐	vmir
绑	vmqjl
绒	vmij
结	vmgr
绔	vmkms
绕	vmjpu
绖	vmmig
绗	vmhon
绘	vmomi
给	vmomr
绚	vmpa
绛	vmheq
络	vmher
绝	vmnau
绞	vmyck
统	vmyiu
绠	vmmlk
绡	vmfb
绢	vmrb
绣	vmhds
绤	vmcor
绥	vmbv
绦	vmhed
继	vmvfd
绨	vmcnh
绩	vmqmo
绪	vmjka
绫	vmgce
绬	vmtlk
续	vmjnk
绮	vmkmr
绯	vmlmy
绰	vmyaj
绱	vmfb'r
绲	vmapp
绳	vmrlu
维	vmog
绵	vmhab
绶	vmbbe
绷	vmbb
绸	vmb'gr
绹	vmpou
绺	vmhyr
绻	vmfqu
综	vmjmf
绽	vmjmo
绾	vmjrr
绿	vmnme
缀	vmeee
缁	vmvvw
缂	vmtlj
缃	vmdbu
缄	vmihr
缅	vmmw'l
缆	vmliu
缇	vmamo
缈	vmbuh
缉	vmrsj
缊	vmabt
缋	vmlmo
缌	vmwp
缍	vmhjm
缎	vmhje
缏	vmomk
缐	vmhae
缑	vmonk
缒	vmyhr
缓	vmbme
缔	vmybb
缕	vmfdv
编	vmisb
缗	vmrpa
缘	vmvno
缙	vmmca
缚	vmibi
缛	vmmvi
缜	vmjbc
缝	vmyhj
缞	vmywv
缟	vmyrb
缠	vmiwg
缡	vmyub
缢	vmtct
缣	vmtxc
缤	vmjoc
缥	vmmwf
缦	vmawe
缧	vmwvf
缨	vmbov
缩	vmjoa
缪	vmsmh
缫	vmvvd
缬	vmgro
缭	vmkcf
缮	vmttr
缯	vmcwa
缰	vmmwm
缱	vmylr
缲	vmrrd
缳	vmwlv
缴	vmhsk
缵	vmhuo
缶	oju
缷	ousl
缸	oum
缹	ouf
缺	oudk
缻	oumvn
缼	ouno
缽	oudm
缾	outt
缿	ouhmr
罀	oulmo
罁	oub'tu
罂	booju
罃	ffbou
罄	geoju
罅	ouypd
罆	ouwjc
罇	outwi
罈	oumwj
罉	oufbq
罊	jeoju
罋	yvgu
罌	bcoju
罍	wwwu
罎	ouami
罏	ouypt
罐	outrg
网	b'kk
罔	b'tyv
罕	bcmj
罖	wloi
罗	wln'i
罘	wlmf
罙	bcd
罚	wlivn
罛	wlhvo
罜	wlyg
罝	wlbm
罞	wlnih
罟	wljr
罠	wlrvp
罡	wlmym
罢	wlgi
罣	wlgg
罤	wlcnh
罥	wlrb
罦	wlbnd
罧	wldd
罨	wlklu
罩	wlyaj
罪	wllmy
罫	wlggy
罬	wleee
罭	wlirm
置	wljbm
罯	wlyta
罰	wlyrn
罱	wljb'j
署	wljka
罳	wlwp
罴	wlgif
罵	wlsqf
罶	wlhhw
罷	wlibp
罸	wlyri
罹	wlpog
罺	wlvvd
罻	wlsfi
罼	wlwtj
罽	wlmfn
罾	wlcwa
罿	wlytg
羀	bkmlw
羁	wltjm
羂	wlvfb
羃	wltab
羄	wlvfj
羅	wlvfg
羆	wlipf
羇	wltjr
羈	wltjf
羉	wlvff
羊	tq
羋	tlq
羌	tghu
羌	tqu
羍	ktq
美	tgk
羏	tqhhh
羐	tgno
羑	tgno
羒	tqcsh
羓	tqau
羔	tgf
羕	tgine
羖	tqhne
羗	tui
羘	btq
羙	tgf
羚	tqoii
羛	tglln
羜	tqjmn
羝	tqhpm
羝	tqhvi
羞	tqng
羟	tqnom
羠	tqkn
羡	tgimo
羢	tqij
羣	srtq
群	srtq
羥	tqmvm
羦	tqjmu
羧	tqice
羨	tgeno
義	tghqi
羪	tqiav
羫	tqjcm
羬	tqihr
羭	tqomn
羮	tgfmo
羯	tqapv
羰	tqukf
羰	tqumf
羱	tqmhf
羲	tghds
羳	tqhdw
羴	tqtqq
羵	tqjtc
羶	tqywm
羷	tqomo
羸	yntq
羹	tgftk
羺	tqmbb
羻	tqixe
羼	stqq
羽	smsim
羾	smm
羿	smt
翀	sml
翁	cism
翂	smcsh
翃	kismm
翄	smje
翅	jesmm
翆	smknj
翇	smikk
翈	wlsmm
翉	dmsmm
翊	ytsmm
翋	smyt
翌	smyt
翍	smdhe
翎	oismm
翏	smohh
翐	smhqo
翑	smpr
習	smha
翓	grsmm
翔	tqsmm
翕	orsmm
翖	orsmm
翗	nnsmm
翘	jusmm
翙	unsmm
翚	smbkq
翛	olom
翜	smkoo
翝	jismm
翞	smyrf
翟	smog
翠	smyoj
翡	lysmm
翢	brsmm
翣	smytv
翤	rbsmm
翥	jasmm
翦	tbnm
翧	jmsmm
翨	smamo
翩	hbsmm
翩	ibsmm
翪	smuce
翫	sammu
翬	smbjj
翭	smonk
翮	mbsmm
翯	smyrb
翰	jjosm
翱	hjsmm
翲	mfsmm
翳	sesmm
翴	smyjj
翵	smhaf
翶	hjsmm
翷	fqsmm
翸	jcsmm
翹	gusmm
翺	hjsmm
翻	hwsmm
翼	smwtc
翽	yhsmm
翾	wvsmm
翿	gismm
耀	fusmg
耀	fvsmg
老	jkp
考	jkys
耄	jphqu
者	jka
耆	jpa
耇	jkpr
耈	jppr
耉	jkyr
耊	jkmig
耋	jpmig
而	mb'll
耍	mbv
耎	mbk
耏	mbhhh
耐	mbdi
耑	umb'l
耒	qd
耓	qdmn
耔	qdnd
耕	qdtt
耖	qdfh
耗	qdhqu
耘	qdmmi
耙	qdau
耚	qddhe
耛	qdir
耜	qdrlr
耝	qdbm
耞	qdksr
耟	qdss
耠	qdomr
耡	qdbms
耢	qdtbs
耣	qdomb
耤	qdta
耥	qdfb'r
耦	qdwlb
耧	qdfdv
耨	qdmvi
耩	qdttb
耪	qdybs
耫	qdqmc
耬	qdllv
耭	qdvii
耮	qdffs
耯	qdtoe
耰	qdmbe
耱	qdidr
耲	qdywv
耳	sj
耴	sju
耵	sjmn
耶	sjnl
耷	ksj
耸	oosj
耹	sjoin
耺	sjmmi
耻	sjylm
耼	sjbmm
耽	sjlbu
耾	sjki
耿	sjf
聀	sji
聁	sjcsh
聂	sjee
聃	sjgb
聄	sjohh
聅	sjok
聆	sjoii
聇	sjmym
聈	sjvis
聉	sjuu
聊	sjhhl
聋	ipsj
职	sjrc
聍	sjjmn
聎	sjlmo
聏	sjmb'l
聐	sjgr
聑	sjsj
聒	sjhjr
聓	mnsj
联	sjtk
聕	sjhgr
聖	srhg
聗	sjkoo
聘	sjlws
聙	sjqmb
聚	sehho
聚	seoho
聛	sjhwj
聜	sjjcm
聝	sjirm
聞	ansj
聟	orsj
聠	sjtt
聡	sjcip
聢	sjjmo
聣	sjhxu
聤	sjyrn
聥	sjhlb
聦	sjpkp
聧	sjnok
聨	sjvit
聩	sjlmo
聪	sjcrp
聫	sjvik
聬	sjcim
聭	sjhui
聮	sjvif
聯	sjvit
聰	sjhwp
聱	gksj
聱	qksj
聲	gesj
聳	hosj
聴	sjjwp
聵	sjlmc
聶	sjsjj
職	sjyia
聸	sjncr
聹	sjjpn
聺	sjjbf
聻	elsj
聼	mjjwp
聽	sgjwp
聾	ypsj
聿	lq
肁	hslq
肂	mnlq
肃	llfl
肄	pklq
肅	lx
肆	silq
肇	hklq
肇	iklq
肈	hilq
肉	ob'o
肊	bn
肋	bks
肌	bhn
肍	bkn
肎	bb
肏	oob'o
肐	bon
肑	bpi
肒	bkni
肓	yvb
肔	bpd
肕	bshi
肖	fb
肗	bv
肘	bdi
肙	rb
肚	bg
肛	bm
肜	bhhh
肝	bmj
肞	bik
肟	bmms
肠	bnsh
股	bhne
肢	bje
肣	boin
肤	bqo
肥	bau
肦	bcsh
肧	bmf
肨	bqj
肩	hsb
肩	isb
肪	byhs
肫	bpu
肬	biku
肭	bob
肮	byhn
肯	ymb
肰	bik
肱	bki
育	yib
肳	bphh
肴	kkb
肵	bhml
肶	bpp
肷	bno
肸	bcj
肹	bcms
肺	bjb
肻	ybb
肼	btt
肽	bki
肾	leb
肿	bl
胀	bpo
胁	bksc
胂	blwl
胃	wb
胄	lwb
胅	bhqo
胆	bam
胇	blln
胈	bikk
胉	bha
胊	bpr
胋	byr
背	lpb
胍	bhvo
胎	bir
胏	blxh
胐	buu
胑	brc
胒	bsp
胓	bmfj
胔	ypob'o
胕	bodi
胖	bfq
胗	bohh
胘	byvi
胙	bos
胚	bmfm
胛	bwl
胜	bhqm
胝	bhpm
胝	bhvi
胞	bpru
胟	bwy'i
胠	bgi
胡	jrb
胢	bmnr
胣	bopd
胤	lvbu
胥	nob
胦	blbk
胧	bikp
胨	bkd
胩	bymy
胪	bys
胫	bnom
胬	veob'o
胭	bw'k
胮	bheq
胯	bkms
胰	bkn
胱	bfmu
胲	byvo
胳	bher
胴	bb'mr
胵	bmig
胶	byck
胷	pub
胸	bpu'k
胹	bmb'l
胺	bjv
胻	bhon
胼	btt
能	ibpp
胾	jiobo
胿	bgg
脀	nemb
脁	blmo
脂	bpa
脃	bshu
脄	bkf
脅	ksksb
脆	bnmu
脇	bkss
脈	bhhv
脉	bine
脊	fcb
脋	shshb
脌	boq
脍	bomi
脎	bkd
脏	big
脐	bykl
脑	byu'k
脒	bfd
脓	bhbv
脔	ycob'o
脕	bnau
脖	bjbd
脗	bphr
脘	bjmu
脙	bije
脚	bgil
脛	bmvm
脜	bmbu
脝	byrn
脞	boog
脟	bbdi
脠	bnkm
脡	bnkg
脢	bowy
脣	mvb
脤	bmmv
脥	bkoo
脦	bipp
脧	bice
脨	bdl
脩	olob
脪	bkkb
脫	bcru
脬	bbnd
脭	brhg
脮	bbv
脯	bijb
脰	bmrt
脱	bcru
脲	bse
脳	bfu'k
脴	bmfr
脵	brmk
脶	brob
脷	bhdn
脸	bomm
脹	bsmv
脺	byoj
脻	bjlo
脼	bmlb
脽	bog
脾	bhwj
脿	bqmv
腀	bomb
腁	bytt
腂	bwd
腃	bfqu
腄	bhjm
腅	bff
腆	btbc
腇	bhdv
腈	bqmb
腉	bhxu
腊	bta
腋	byok
腌	bklu
腍	boip
腎	seb
腏	beee
腐	ioib
腑	bioi
腒	bsjr
腓	blmy
腔	bjcm
腕	bjnu
腖	bdw
腗	blwl
腘	bw'mi
腙	bjmf
腚	bjmo
腛	bsmg
腜	btmd
腝	bmbk
腞	bvno
腟	bjmg
腠	bqkk
腡	bbb'r
腢	bwlb
腣	bybb
腤	byta
腥	bahm
腦	bvvw
腧	bomn
腨	bumb
腩	bjb'j
腪	bbjj
腫	bhjg
腬	bnhd
腭	brrs
腮	bwp
腯	bhju
腰	bmwv
腱	bnkq
腲	bwmv
腳	bcrl
腴	bhxo
腵	brse
腶	bhje
腷	bmrw
腸	bamh
腹	boae
腺	bhae
腻	bipo
腼	bmw'l
腽	babt
腾	bfqm
腿	byav
膀	bybs
膁	btxc
膂	yvb
膃	bwot
膄	bhxe
膅	bilr
膆	bqmf
膇	byhr
膈	bmrb
膉	btct
膊	bibi
膋	ffbb
膌	bfcb
膍	bhwp
膎	bbvk
膏	yrbb
膐	yvob'o
膑	bjoc
膒	bs'rr
膓	boah
膔	bixp
膕	bw'im
膖	byhj
膗	buog
膘	bmwf
膙	bnii
膚	ypwb
膛	bfbg
膜	btak
膝	bdoe
膞	bjii
膟	byij
膠	bsmh
膡	bfqu
膢	bllv
膣	bjcg
膤	bmbs
膥	dsob'o
膦	bfdq
膧	bytg
膨	bgth
膩	bipc
膪	bybr
膫	bkcf
膬	bhuu
膭	blmc
膮	bggu
膯	bnot
膰	bhdw
膱	byia
膲	bogf
膳	btgr
膳	bttr
膴	botf
膵	btyj
膶	bang
膷	bvhl
膸	bykb
膹	bjtc
膺	iogb
膻	bywm
膼	bybb
膽	bncr
膾	boma
膿	btwv
臀	seb
臁	bitc
臂	sjb
臃	byvg
臄	bypo
臅	bwli
臆	bytp
臇	bogs
臈	btav
臉	bomo
臊	brrd
臋	seob'o
臌	bgte
臍	byx
臎	bsmj
臏	bjmc
臐	bhgf
臑	bmbb
臒	btoe
臓	btis
臔	bsec
臕	bipf
臖	hcb
臗	bjti
臘	bvvv
臙	btlf
臚	bypt
臛	bmbg
臜	bhuo
臝	ynwd
臞	bbug
臟	btis
臠	vfob'o
臡	tgob'o
臢	bhuc
臣	s'lsl
臤	sle
臥	slo
臦	sls'll
臧	ims'll
臨	slorr
臩	sskll
自	hbu
臫	huu
臬	hud
臭	huik
臮	huooo
臯	huej
臰	humnp
臱	hujcs
臲	hdnmu
至	mig
致	mgok
臵	mgher
臶	mgkld
臷	jimig
臸	mgmig
臹	mgihs
臺	grbg
臻	mgqkd
臼	hx
臽	nhx
臾	hxo
臿	hjhx
舀	bhx
舁	hxt
舂	qkhx
舃	hxyf
舄	hxpf
舄	hxyf
舅	hxwks
舆	hxkc
與	hxyc
興	hxbc
舉	hcq
舊	togx
舋	hbbm
舌	hjr
舍	omjr
舎	ogr
舏	hrvl
舐	hrhvp
舑	hrgb
舒	ornin
舓	hraph
舔	hrhkp
舔	hrmkp
舕	hrff
舖	orijb
舗	orijb
舘	orjrr
舙	hrhrr
舚	hrncr
舛	niq
舜	bbnq
舝	dmvvq
舞	otniq
舟	hby'i
舠	hysh
舡	hym
舢	hyu
舣	hyik
舤	hyhn'i
舥	hyau
舦	hyki
舧	hyhn'i
舨	hyhe
舩	hyci
航	hyyhn
舫	hyyhs
般	hyhne
舭	hypp
舮	hyis
舯	hyl
舰	hybhu
舱	hyosu
舲	hyoii
舳	hylw
舴	hyos
舵	hyjp
舶	hyha
舷	hyyvi
舸	hymnr
船	hycr
船	hyhnr
舺	hywl
舻	hyys
舼	hytc
舽	hyheq
舾	hymcw
舿	hykms
艀	hybnd
艁	hyhgr
艂	hyhej
艃	hywg
艄	hyfb
艅	hyomd
艆	hyiav
艇	hynkg
艈	hyyiu
艉	hyshu
艊	hyhab
艋	hyndt
艌	hyoip
艍	hysjr
艎	hyhag
艏	hythu
艐	hyuce
艑	hyhsb
艒	hyabu
艓	hyptd
艔	hyite
艕	hyybs
艖	hytqm
艗	hytct
艘	hyhxe
艙	hyoir
艚	hytwa
艛	hyllv
艜	hykpb
艝	hymbs
艞	hyhlo
艟	hyytg
艠	hynot
艡	hyfbw
艢	hygow
艣	hyyps
艤	hytgi
艥	hyrji
艦	hysit
艧	hytoe
艨	hytbo
艩	hyyx
艪	hynwa
艫	hyypt
艬	hynri
艭	hyoge
艮	av
良	iav
艰	eav
艱	toav
色	nau
艳	qjnau
艴	lnnau
艵	ttnau
艶	ttnau
艷	utnau
艸	uu
艹	jj
艺	tn
艻	tks
艼	tmn
艽	tkn
艾	tk
艿	tnhs
芀	tsh
芁	thn
节	tsl
芃	thn'i
芄	tkni
芅	tip
芆	tik
芇	tlb
芈	tq
芉	tmj
芊	thj
芋	tmd
芌	tmms
芍	tpi
芎	tn
芏	tg
芐	tmy
芑	tsu
芒	tyv
芓	tnd
芔	uuu
芕	tn'i
芖	tk
芗	tvvh
芘	tpp
芙	tqo
芚	tpu
芛	tsk
芜	tmku
芝	tino
芞	tomn
芟	thne
芠	tyk
芡	tno
芢	tomm
芣	tmf
芤	tndu
芥	toll
芦	tis
芧	tnin
芨	tnhe
芩	toin
芪	thvp
芫	tmmu
芬	tcsh
芭	tau
芮	tob
芯	tp
芰	tje
花	top
芲	top
芳	tyhs
芴	tphh
芵	tdk
芶	tpi
芷	tylm
芸	tmmi
芹	thml
芺	thk
芻	pupu
芼	thqu
芽	tmvh
芾	tjb
芿	tons
苀	tyhn
苁	too
苂	tf
苃	tke
苄	tyy
苅	tkln
苆	tpsh
苇	tqs
苈	tmks
苉	ts'c
苊	tmsu
苋	tbhu
苌	tpo
苍	tosu
苎	tjm
苏	tksc
苐	tnlh
苑	tniu
苒	tgb
苓	toii
苔	tir
苕	tshr
苖	tlw
苗	tw
苘	tb'r
苙	tyt
苚	tb'q
苛	tmnr
苜	tbu
苝	tlmp
苞	tpru
苟	tpr
苠	trvp
苡	tvio
苢	trlr
苣	tss
苤	tmfm
若	tkr
苦	tjr
苧	tjmn
苨	tsp
苩	tha
苪	tmob
苫	tyr
苬	tw'o
苭	tvis
苮	tou
苯	tdm
苰	tni
英	tlbk
苲	tos
苳	they
苴	tbm
苵	thqo
苶	tof
苷	tt'm
苸	thfd
苹	tmfj
苺	twy'i
苻	todi
苼	thqm
苽	thvo
苾	tph
苿	tjd
茀	tlln
茁	tuu
茂	tih
范	tesu
茄	tksr
茅	tnih
茆	thhl
茇	tike
茇	tikk
茈	tymp
茉	tdj
茊	tom
茋	thpm
茌	tog
茍	tpr
茎	tnom
茏	tikp
茐	tpkk
茑	tpym
茒	tnil
茓	tjc
茔	tbg
茕	tbnj
茖	ther
茗	tnir
茘	tshh
茙	tij
茚	thpl
茛	tav
茜	tmcw
茝	ts'll
茞	ts'll
茟	tlq
茠	tod
茡	tjnd
茢	tmnn
茣	trvk
茤	tnin
茥	tgg
茦	tdb
茧	tlmi
茨	timo
茨	tmmo
茩	thmr
茪	tfmu
茫	teyv
茬	tklg
茭	tyck
茮	tymf
茯	toik
茰	tlwk
茱	thjd
茲	tvii
茳	tem
茴	tw'r
茵	tw'k
茶	tod
茷	toi
茸	tsj
茹	tvr
茺	tyiu
茻	uuuu
茼	tb'mr
茽	tol
茾	tmt
茿	tmhn
荀	tpa
荁	tmam
荂	tkms
荃	tomg
荄	tyvo
荅	tomr
荆	ttln
荇	thon
荈	tniq
草	taj
荊	tmtn
荋	tmb'l
荌	tjv
荍	tvlk
荎	tmig
荏	tohg
荐	tkld
荑	tkn
荒	tyvu
荓	ttt
荔	tkss
荕	tbks
荖	tjkp
荗	tihi
荘	tlmg
荙	tyk
荚	tkt
荛	tjpu
荜	tppj
荝	tbon
荞	thkl
荟	tomi
荠	tykl
荡	tenh
荢	tjmd
荣	tbd
荤	tbkq
荥	tbe
荦	tbhq
荧	tbf
荨	tsmi
荩	tsoy
荪	tndf
荫	tnlb
荬	tnyk
荭	tvmm
荮	tvmi
药	tvmi
荰	tdg
荱	tshu
荲	twg
荳	tmrt
荴	tqqo
荵	tsip
荶	tron
荷	tomr
荸	tjbd
荹	tylh
荺	tgpm
荻	tkhf
荼	tomd
荽	tbv
荾	tice
荿	tihs
莀	tmmv
莁	tmoo
莂	trsn
莃	tkkb
莄	tmlk
莅	toyt
莆	tijb
莇	tbms
莈	tene
莉	thdn
莊	tvmg
莋	toos
莌	tcru
莍	tije
莎	tefh
莏	tqfh
莐	telu
莑	thej
莒	trhr
莒	trr
莓	towy
莔	tw'cb
莕	tdr
莖	tmvm
莗	tjwj
莘	tytj
莙	tskr
莚	tnkm
莛	tnkg
莜	tolk
莝	toog
莞	tjmu
莟	toir
莠	thds
莡	tryo
莢	tkoo
莣	tyvp
莤	tmcw
莥	tkhg
莦	tfb
莧	tbuu
莨	tiav
莩	tbnd
莪	thqi
莫	tak
莬	tnau
莭	tail
莮	twks
莯	ted
莰	tgno
莱	tdt
莲	tykq
莳	tadi
莴	trob
莵	thai
莶	tomm
获	tkhk
莸	tkhu
莹	tbmi
莺	tbpm
莻	tnsp
莼	tvmu
莽	tikt
莾	tkjt
莿	tdbn
菀	tjnu
菁	tqmb
菂	thai
菃	tess
菄	tdw
菅	tjrr
菆	tsje
菇	tvjr
菈	tqyt
菉	tvne
菊	tpfd
菋	trjd
菌	tw'hd
菍	toip
菎	tapp
菏	temr
菐	tcto
菑	tvvw
菒	tad
菓	twd
菔	tbse
菕	tomb
菖	taa
菗	tqlw
菘	tdci
菙	thjm
菚	tii
菛	tan
菜	tbd
菝	tqie
菝	tqik
菞	thdh
菟	tnai
菠	tede
菡	tu'ne
菢	tqpu
菣	tsle
菤	tfqu
菥	tdhl
菦	tyhl
菧	tihm
菨	tytv
菩	tytr
菪	tjmr
菫	tmlm
菬	tesr
菭	teir
菮	tilo
華	tmtj
菰	tndo
菱	tgce
菲	tlmy
菳	tc
菴	tklu
菵	tb'tv
菶	tqkq
菷	tsmb
菸	tysy
菹	tebm
菺	thsb
菻	tdd
菼	tff
菽	tyfe
菾	thkp
菾	tmkp
菿	tmgn
萀	typu
萁	ttmc
萂	thdr
萃	tyoj
萄	tpou
萅	tpua
萆	thwj
萇	tsmv
萈	tbui
萉	tbau
萊	tdoo
萋	tjlv
萌	tab
萍	temj
萎	thdv
萏	tnhx
萐	tjlo
萑	tog
萒	tycu
萓	tjbm
萔	tqsr
萕	tykl
萖	thxu
萗	tjmf
萘	tkmf
萙	tdlu
萚	tqeq
萛	tbut
萜	tlbr
萝	twln
萞	tbop
萟	thdi
萠	tbb
萡	teha
萢	tepu
萣	tjmo
萤	tbli
营	tbrr
萦	tbvf
萧	tlll
萨	tnlh
萩	thdf
萪	thdj
萫	thda
萬	twlb
萭	thlb
萮	tomn
萯	tnbc
萰	tdw'f
萱	tjmm
萲	tbme
萳	tjb'j
萴	tbcn
萵	tbb'r
萶	tqka
萷	tfbn
萸	thxo
萹	thsb
萺	tabu
萻	tyta
萼	trrs
落	tehr
萾	tnst
萿	tehr
葀	tqhr
葁	ttgv
葂	tnus
葃	taos
葄	tbos
葅	toom
葆	tord
葇	tnhd
葈	tird
葉	tptd
葊	tort
葋	tbpr
葌	tvvv
葍	tmrw
葎	thoq
葏	telq
葐	tcst
葑	tggi
葒	tvfm
葓	tetc
葔	tonk
葕	thon
葖	tjck
著	tjka
葘	tvmw
葙	tdbu
葚	ttmv
葛	tapv
葜	tqhk
葝	tmms
葞	tnsj
葟	thag
葠	tose
葡	tpib
葢	tkit
董	thjg
葤	tvfi
葥	ttbn
葦	tdmq
葧	tjds
葨	twmv
葩	thau
葪	tnbn
葫	tjrb
葬	tmpt
葭	trse
葮	thje
葯	tvfi
葰	toie
葱	tpkp
葲	thae
葳	tihv
葴	tihr
葵	tnok
葶	tyrn
葷	tbjj
葸	twp
葹	tysd
葺	trsj
葻	thn'i
葼	tuce
葽	tmwv
葾	tnup
葿	tahu
蒀	tabt
蒁	tyid
蒂	tybb
蒃	tvno
蒄	tbmi
蒅	tend
蒆	tmnv
蒇	tiho
蒈	tppa
蒉	tlmo
蒊	topp
蒋	tlmi
蒌	tfdv
蒍	tikf
蒎	tehv
蒏	tbmw
蒐	thui
蒑	thse
蒒	thrb
蒓	tvfu
蒔	tagi
蒕	twot
蒖	tjbc
蒗	teiv
蒘	tvrq
蒙	tbmo
蒚	tmrb
蒛	touk
蒜	tmff
蒝	tmhf
蒞	teot
蒟	tytr
蒠	thup
蒡	tybs
蒢	tnld
蒣	thod
蒤	teod
蒥	thhw
蒦	toge
蒧	tihr
蒨	toqb
蒩	thdm
蒪	tibi
蒫	ttqm
蒬	tbni
蒭	tpuu
蒮	tobg
蒯	tbln
蒰	thye
蒱	tqib
蒲	teib
蒳	tvfb
蒴	ttub
蒵	tbvk
蒶	tvfh
蒷	trbc
蒸	tnef
蒹	ttxc
蒺	tkok
蒻	tnmm
蒼	toir
蒽	twkp
蒾	tyfd
蒿	tyrb
蓀	tndf
蓁	tqkd
蓂	tbac
蓃	thxe
蓄	tyvw
蓅	teyu
蓆	titb
蓇	tbbb
蓈	tiil
蓉	tjcr
蓊	tcim
蓋	tgit
蓌	tooe
蓍	tjpa
蓎	tilr
蓏	thoo
蓐	tmvi
蓑	tywv
蓒	tjjj
蓓	toyr
蓔	ttgf
蓕	tdgg
蓖	thwp
蓗	thoo
蓘	tycv
蓙	tiog
蓚	tolh
蓛	tdbk
蓜	tmwu
蓝	tlit
蓞	tbhx
蓟	tnmn
蓠	tyub
蓡	tese
蓢	taib
蓣	tnno
蓤	time
蓥	tbc
蓦	takm
蓧	told
蓨	tolb
蓩	tnhs
蓪	tynb
蓫	tymo
蓬	tyhj
蓭	tiku
蓮	tyjj
蓯	thoo
蓰	thoo
蓱	tett
蓲	ts'rr
蓳	ttlm
蓴	tjii
蓵	tqjo
蓶	trog
蓷	tqog
蓸	ttwa
蓹	thol
蓺	tggi
蓻	tgji
蓼	tsmh
蓽	twtj
蓾	tyw'i
蓿	tjoa
蔀	tyrl
蔁	tytj
蔂	twvf
蔃	tnii
蔄	tanr
蔅	tanv
蔆	tege
蔇	taiu
蔈	tmwf
蔉	tycv
蔊	tfaj
蔋	teye
蔌	tdlo
蔍	tixp
蔎	tyre
蔏	tycb
蔐	tycb
蔑	twli
蔒	tsrf
蔓	tawe
蔔	tpmw
蔕	tkpb
蔖	typm
蔗	titf
蔘	tiih
蔙	tyso
蔚	tsfi
蔛	tnbj
蔜	tgsk
蔝	tbud
蔞	tllv
蔟	tysk
蔠	tvfy
蔡	tbof
蔢	teev
蔣	tvmi
蔤	tjpu
蔥	thwp
蔦	thaf
蔧	tqjm
蔨	tw'fu
蔩	tjmc
蔪	tjjl
蔫	tmyf
蔬	tnmu
蔭	tnli
蔮	tw'im
蔯	tnlw
蔰	thsu
蔱	tkce
蔲	tjmk
蔳	teqb
蔴	tijc
蔵	tihs
蔶	tqmc
蔷	tgcw
蔸	thvu
蔹	tomk
蔺	tlsg
蔻	tjme
蔼	tivv
蔽	tfbk
蔾	thhd
蔿	tbhf
蕀	tdbb
蕁	tsmi
蕂	tbfs
蕃	thdw
蕄	tanp
蕅	tewb
蕆	tihc
蕇	trrj
蕈	tmwj
蕉	togf
蕊	tppp
蕋	tymm
蕌	taaa
蕍	teon
蕎	thkb
蕏	tkha
蕐	tmoq
蕑	tanb
蕒	twlc
蕓	tmbi
蕔	tgje
蕕	tkhw
蕖	tesd
蕗	trmr
蕘	tggu
蕙	tjip
蕚	trrs
蕛	thdh
蕜	tlyp
蕝	tvfu
蕞	tase
蕟	tnoe
蕠	tvrf
蕡	tjtc
蕢	tlmc
蕣	tbbq
蕤	tmom
蕥	tmhg
蕦	thhc
蕧	thoe
蕨	tmto
蕩	teah
蕪	totf
蕫	tytg
蕬	tvff
蕭	tlx
蕮	thxf
蕯	tnlm
蕰	teat
蕱	thdb
蕲	tcjl
蕳	tana
蕴	tvmt
蕵	tniv
蕶	tmbi
蕷	tnnc
蕸	tyre
蕹	tyvg
蕺	trji
蕻	tsic
蕼	tsiq
蕽	ttwv
蕾	tmbw
蕿	tfbe
薀	tewt
薁	thbk
薂	thsk
薃	teyb
薄	teii
薅	tvmi
薆	tbbe
薇	thok
薈	toma
薉	tymh
薊	tnfn
薋	tmoc
薌	tvhl
薍	tbbu
薎	twli
薏	tytp
薐	thde
薑	tmwm
薒	tyed
薓	tese
薔	tgow
薕	titc
薖	tybb
薗	tw'gv
薘	tygq
薙	tokg
薚	tmnh
薛	thrj
薜	tsrj
薝	tncr
薞	tmnv
薟	tomo
薠	tfmc
薡	tbul
薢	tnbq
薣	tgte
薤	tmnm
薥	twli
薦	tixf
薧	tyrp
薨	twlp
薩	tnlm
薪	tydl
薫	thgf
薬	tiod
薭	thdj
薮	tfvk
薯	twla
薰	thgf
薱	ttgi
薲	tjmc
薳	tygv
薴	tjpn
薵	tgni
薶	tbhg
薷	tmbb
薸	temf
薹	tgrg
薺	tyx
薻	tevd
薼	tipg
薽	tmgn
薾	tmfb
薿	tpko
藀	tfff
藁	tyrd
藂	tseo
藃	tybo
藄	ttcf
藅	twln
藆	tjtq
藇	thxc
藈	tbuk
藉	tqda
藊	thdb
藋	tsmg
藌	tjpi
藍	tsit
藎	tlmt
藏	tims
藐	tbhu
藑	tnbe
藒	thdv
藓	tnmq
藔	tjkf
藕	tqdb
藖	tsec
藗	tydo
藘	typp
藙	tyoe
藚	tgwc
藛	tjhf
藜	thhe
藝	tgii
藞	tmrr
藟	twww
藠	thaa
藡	tyyb
藢	thok
藣	twlp
藤	tbfe
藥	tvid
藦	ticq
藧	tvfe
藨	tipf
藩	tehw
藪	tlvk
藫	temj
藬	tnlc
藭	tjcn
藮	tdof
藯	tsip
藰	thcn
藱	tkhi
藲	tds'r
藳	tyrd
藴	tvft
藵	todv
藶	tmhm
藷	tyra
藸	tmoa
藹	tyrv
藺	tang
藻	terd
藼	tjqp
藽	tydu
藾	tdlc
藿	tmbg
蘀	tqwj
蘁	tmgr
蘂	tppd
蘃	tymd
蘄	trjl
蘅	thon
蘆	typt
蘇	tnfd
蘈	thuc
蘉	twle
蘊	tvft
蘋	tyhc
蘌	thlf
蘍	thfs
蘎	tmbu
蘏	tpfc
蘐	tyre
蘑	ticr
蘑	tidr
蘒	thdu
蘓	thdf
蘔	tpdc
蘕	tvfj
蘖	tjd
蘗	tsjd
蘘	tyrv
蘙	tsem
蘚	tnfq
蘛	ttvb
蘜	ttjd
蘝	tooo
蘞	took
蘟	tnlp
蘠	tvmw
蘡	tbcv
蘢	tybp
蘣	ttcg
蘤	thaf
蘥	tomb
蘦	tmbr
蘧	tyyo
蘨	tbuf
蘩	tokf
蘪	tipd
蘫	test
蘬	thmb
蘭	tanw
蘮	twln
蘯	teht
蘰	tvfe
蘱	tfkc
蘲	twwg
蘳	ttcg
蘴	tujt
蘵	tsja
蘶	thvi
蘷	tmce
蘸	tmgf
蘸	tmwf
蘹	tpyv
蘺	tybg
蘻	tjef
蘼	ticy
蘼	tidy
蘽	twwd
蘾	tgyv
蘿	twlg
虀	tysm
虁	tmce
虂	tmbr
虃	teom
虄	tlim
虅	tbff
虆	twwf
虇	tntg
虈	trrr
虉	tmbf
虊	tvfd
虋	thbh
虌	tfku
虍	yp
虎	yphn
虎	yphu
虏	ypks
虐	ypsm
虑	ypp
虒	hypu
虓	knypu
虔	ypyk
處	yphen
虖	yphfd
虗	ypom
虘	ypbm
虙	ypph
虚	yptc
虛	yptm
虜	ypwks
虝	yuphh
虞	yprmk
虞	yprvk
號	rsypu
虠	ykypu
虡	yptmc
虢	biypn
虢	biypu
虣	mmypu
虤	yuypu
虥	yuii
虦	iiypu
虧	ygmms
虨	ydhhh
虩	ffypu
虪	yuolf
虫	lmi
虬	liu
虭	lish
虮	lihn
虯	livl
虰	limn
虱	nhli
虲	liy
虳	lipi
虴	lihp
虵	lipd
虶	limd
虷	limj
虸	lind
虹	lim
虺	mulmi
虻	liyv
虼	lion
虽	rlmi
虾	limy
虿	mslmi
蚀	nvlmi
蚁	liik
蚂	linvm
蚃	vhlmi
蚄	liyhs
蚅	lihsu
蚆	liau
蚇	liso
蚈	limt
蚉	yklmi
蚊	liyk
蚋	liob
蚌	liqj
蚍	lipp
蚎	lia
蚏	lib
蚐	lipmm
蚑	lije
蚒	liby
蚓	linl
蚔	lihvp
蚕	mklmi
蚖	limmu
蚗	lidk
蚘	liiku
蚙	lioin
蚚	lihml
蚛	lil
蚜	limvh
蚝	lihqu
蚞	lid
蚟	limg
蚠	cshi
蚡	licsh
蚢	liyhn
蚣	lici
蚤	eilmi
蚥	lick
蚦	libmm
蚧	lioll
蚨	liqo
蚩	umli
蚪	liyj
蚫	lipru
蚬	libhu
蚭	lisp
蚮	lioip
蚯	liom
蚰	lilw
蚱	lios
蚲	limfj
蚳	lihpm
蚴	livis
蚵	limnr
蚶	lit'm
蚷	liss
蚸	lihmy
蚹	liodi
蚺	ligb
蚻	dulmi
蚼	lipr
蚽	limfm
蚾	lidhe
蚿	liyvi
蛀	liyg
蛁	lishr
蛂	liikk
蛃	limob
蛄	lijr
蛅	liyr
蛆	libm
蛇	lijp
蛈	lihqo
蛉	lioii
蛊	libt
蛋	nolmi
蛌	lihvo
蛍	fblmi
蛎	limms
蛏	lieg
蛐	litw
蛑	liihq
蛒	liher
蛓	jilmi
蛔	liw'r
蛕	likb
蛖	liiuh
蛗	hrlmi
蛘	litq
蛙	ligg
蛚	limnn
蛛	lihjd
蛜	liosk
蛝	liav
蛞	lihjr
蛟	liyck
蛠	likss
蛡	lismm
蛢	litt
蛣	ligr
蛤	liomr
蛥	linin
蛦	likn
蛧	lib'kk
蛨	lima
蛩	mnlmi
蛪	qhlmi
蛫	linmu
蛬	tclmi
蛭	limig
蛮	yclmi
蛯	lijkp
蛰	qilmi
蛱	likt
蛲	lijpu
蛳	lillb
蛴	liykl
蛵	limvm
蛶	libdi
蛷	liije
蛸	lifb
蛹	linib
蛺	likoo
蛻	licru
蛼	lijwj
蛽	libuc
蛾	lihqi
蛿	lioir
蜀	wlpli
蜁	liono
蜂	lihej
蜃	mvlmi
蜄	limmv
蜅	liijb
蜆	libuu
蜇	qllmi
蜈	lirmk
蜈	lirvk
蜉	libnd
蜊	lihdn
蜋	liiav
蜌	lippg
蜍	liomd
蜎	lirb
蜏	lihds
蜐	ligis
蜑	nmlmi
蜒	linkm
蜒	linkv
蜓	linkg
蜔	lipw
蜕	licru
蜖	liw'sl
蜗	lirob
蜘	liokr
蜙	lidci
蜚	lylmi
蜛	lisjr
蜜	jphi
蜝	tclmi
蜞	litmc
蜟	liyib
蜠	liw'hd
蜡	lita
蜢	lindt
蜣	litgu
蜣	litqu
蜤	dllmi
蜥	lidhl
蜦	liomb
蜧	lihsk
蜨	lijlo
蜩	lib'gr
蜪	lipou
蜫	liapp
蜬	liu'ne
蜭	linhx
蜮	liirm
蜯	liqkq
蜰	bulmi
蜱	lihwj
蜲	lihdv
蜳	liyrd
蜴	liaph
蜵	lilxl
蜶	liyoj
蜷	lifqu
蜸	selmi
蜹	litob
蜺	lihxu
蜻	liqmb
蜼	liog
蜽	limlb
蜾	liwd
蜿	lijnu
蝀	lidw
蝁	mmlmi
蝂	lille
蝃	lieee
蝄	lib'tv
蝅	mklmi
蝆	litq
蝇	lirlu
蝈	liw'mi
蝉	licwj
蝊	lijmo
蝋	lifhn
蝌	lihdj
蝍	liail
蝎	liapv
蝏	liyrn
蝐	liabu
蝑	linob
蝒	limw'l
蝓	liomn
蝔	lippa
蝕	oilmi
蝖	lijmm
蝗	lihag
蝘	lis'av
蝙	lihsb
蝙	liisb
蝚	linhd
蝛	liihv
蝜	linbc
蝝	livno
蝞	liahu
蝟	liwb
蝠	limrw
蝡	limbk
蝢	limbc
蝣	liysd
蝤	litcw
蝥	nklmi
蝦	lirse
蝧	litlk
蝨	njlii
蝩	lihjg
蝪	liamh
蝫	lijka
蝬	liuce
蝭	liamo
蝮	lioae
蝯	libme
蝰	likgg
蝱	yvlii
蝲	lidln
蝳	liqmy
蝴	lijrb
蝵	hflmi
蝶	liptd
蝷	liitu
蝸	libb'r
蝹	liwot
蝺	lihlb
蝻	lijb'j
蝼	lifdv
蝽	liqka
蝾	litbd
蝿	liwlu
螀	lilmi
螁	liyav
螂	liiil
螃	liybs
螄	lihrb
螅	lihup
螆	litvi
螇	libvk
螈	limhf
螉	licim
螊	litxc
螋	lihxe
螌	helmi
融	mblmi
螎	limrb
螏	likok
螐	lihrf
螑	lihuk
螒	jjoli
螓	liqkd
螔	lihyu
螕	lihwp
螖	libbb
螗	liilr
螘	liumt
螙	dlii
螚	iplmi
螛	lijqr
螜	gelmi
螝	lihui
螞	lisqf
螟	libac
螠	litct
螡	yklii
螢	ffbli
螣	bfqi
螤	yilwo
螥	lioir
螦	liqmf
螧	lijpa
螨	litmb
螩	liold
螪	liycb
螫	gklmi
螬	litwa
螭	liyub
螮	likpb
螯	gklmi
螯	qklmi
螰	liixp
螱	silmi
螲	lijcg
螳	lifbg
螴	nwlmi
螵	limwf
螶	sslii
螷	ihji
螸	colmi
螹	lijjl
螺	liwvf
螻	lillv
螼	litlm
螽	hylii
螾	lijmc
螿	vilmi
蟀	liyij
蟁	rplii
蟂	lihad
蟃	liawe
蟄	gilmi
蟅	liitf
蟆	litak
蟇	taki
蟈	liw'im
蟉	lismh
蟊	nhlii
蟋	lihdp
蟌	lihwp
蟍	lihnd
蟎	litlb
蟏	litll
蟐	lifbb
蟑	liytj
蟒	litit
蟓	linao
蟔	liwgf
蟕	liypb
蟖	litcl
蟗	jbuui
蟘	liopc
蟙	liyia
蟚	ghlmi
蟛	ligth
蟜	lihkb
蟝	liesd
蟞	fklmi
蟟	likcf
蟠	lihdw
蟡	liikf
蟢	ligrr
蟣	livii
蟤	liruc
蟥	litlc
蟦	lijtc
蟧	liffs
蟨	molmi
蟩	limto
蟪	lijip
蟫	limwj
蟬	lirrj
蟭	liogf
蟮	littr
蟯	liggu
蟰	lilx
蟱	liotf
蟲	lilii
蟳	lismi
蟴	tllmi
蟵	limmi
蟶	lisrg
蟷	lifbw
蟸	molii
蟹	nqlmi
蟺	liywm
蟻	litgi
蟼	tklmi
蟽	liygq
蟾	lincr
蟿	jelmi
蠀	limoc
蠁	vllmi
蠂	litpd
蠃	yrbln
蠄	lioyb
蠅	lirxu
蠆	twbi
蠇	litwb
蠈	bjlmi
蠉	liwlv
蠊	liitc
蠋	liwli
蠌	liwlj
蠍	liavo
蠎	litkt
蠏	linbq
蠐	liyx
蠑	liffd
蠒	mblmi
蠓	litbo
蠔	liyro
蠕	limbb
蠖	litoe
蠗	lismg
蠘	lijig
蠙	lijmc
蠚	tkri
蠛	litwi
蠜	ddkli
蠝	liwww
蠞	hali
蠟	livvv
蠠	mwlii
蠡	volii
蠢	qalii
蠣	limtb
蠤	twlii
蠥	ujlmi
蠦	liypt
蠧	gbmi
蠨	litlx
蠩	liyra
蠪	yplmi
蠫	bnlii
蠬	liybp
蠭	yjlii
蠮	lisem
蠯	ihji
蠰	liyrv
蠱	lilit
蠲	ttwli
蠳	libcv
蠴	litwa
蠵	liuob
蠶	muali
蠷	libug
蠸	litrg
蠹	jbmri
蠺	mkali
蠻	vflmi
蠼	libue
蠽	filii
蠾	lisei
蠿	vmlii
血	hbt
衁	yvhbt
衂	htshi
衃	htmf
衄	htng
衅	htfq
衆	htoho
衇	hthhv
衈	htsj
衉	hther
衊	httwi
衋	lqmat
行	hommn
衍	hoemn
衎	homjn
衏	homun
衐	hossn
衑	hooin
衒	hoyin
術	hoicn
衔	hoopn
衕	hobrn
衖	hotcn
街	hoggn
衘	hoomn
衙	homrn
衚	hojrn
衛	hodqn
衜	hotun
衝	hohgn
衞	hodbn
衟	hovun
衠	hojcn
衡	honkn
衢	hobgn
衣	yhv
衤	inlo
补	ly
衦	lmj
衧	lmd
表	qmv
衩	le'i
衪	lpd
衫	lhhh
衬	ldi
衭	lqo
衮	ycihv
衯	lcsh
衰	ywmv
衱	lnhe
衲	lob
衳	lci
衴	llbu
衵	la
衶	ll
衷	ylhv
衸	loll
衹	lhvp
衺	ymhv
衻	lbmm
衼	lje
衽	lhg
衾	oinv
衿	loin
袀	lpmm
袁	grhv
袂	ldk
袃	phyhv
袄	lhk
袅	pysv
袆	lqs
袇	lby
袈	kryhv
袉	ljp
袊	loii
袋	opyhv
袌	ypuv
袍	lpru
袎	lvis
袏	lkm
袐	lph
袑	lshr
袒	lam
袓	lbm
袔	lmnr
袕	ljc
袖	llw
袗	lohh
袘	lopd
袙	lha
袚	likk
袛	lhpm
袜	ldj
袝	lodi
袞	ycrhv
袟	lhqo
袠	yhov
袡	lgb
袢	lfq
袣	lpt
袤	ynhv
袥	lmr
袦	luu
袧	lpr
袨	lyvi
袩	lyr
袪	lgi
被	ldhe
袬	yirv
袭	ipyhv
袮	lof
袯	live
袰	wyyhv
袱	loik
袲	yniv
袳	lnin
袴	lkms
袵	lohg
袶	lheq
袷	lomr
袸	lkld
袹	lma
袺	lgr
袻	lmb'l
袼	lher
袽	lvr
袾	lhjd
袿	lgg
裀	lw'k
裁	jiyhv
裂	mnyhv
裃	lymy
裄	lhon
装	lgyhv
裆	lfsm
裆	lfs'm
裇	lhbt
裈	lbkq
裉	lav
裊	hayv
裋	lmrt
裌	lkoo
裍	lw'd
裎	lrhg
裎	lrmg
裏	ywgv
裐	lrb
裑	lhxh
裒	yhxv
裓	lit
裔	yvb'cr
裕	lcor
裖	lmmv
裗	lyiu
裘	ieyhv
裙	lskr
裚	qlyhv
裛	yrav
補	lijb
裝	vgyhv
裞	lcru
裟	ehyhv
裠	sryhv
裡	lwg
裢	lykq
裣	lomm
裤	likq
裥	llsa
裦	yhhv
裧	lff
裨	lhwj
裩	lapp
裪	lpou
裫	llxl
裬	lgce
裭	lypu
裮	laa
裯	lb'gr
裰	leee
裱	lqmv
裲	lmlb
裳	fbryv
裴	lyyhv
裵	ylyv
裶	llmy
裷	lfqu
裸	lwd
裹	ywdv
裺	lklu
裻	yeyhv
裼	laph
製	hnyhv
裾	lsjr
裿	lkmr
褀	ltmc
褁	wdhv
褂	lggy
褃	lymb
褄	ljlv
褅	lybb
褆	lamo
複	loae
褈	lhjg
褉	lqhk
褊	lhsb
褊	lisb
褋	lptd
褌	lbjj
褍	lumb
褎	yhdv
褏	yhwv
褐	lapv
褑	lbme
褒	yodv
褓	lord
褔	lmrw
褕	lomn
褖	lvno
褗	lsav
褘	ldmq
褙	llpb
褚	ljka
褛	lfdv
褜	buyhv
褝	lfwj
褞	lwot
褟	lasm
褠	lttb
褡	ltor
褢	yhiv
褣	ljcr
褤	lgrv
褥	lmvi
褦	libp
褧	sfyhv
褨	ltqm
褩	heyhv
褪	lyav
褫	lhyn
褫	lhyu
褬	leed
褭	ysfv
褮	ffbyv
褯	litb
褰	jtcv
褱	ywlv
褲	lijj
褳	lyjj
褴	llit
褵	lyub
褶	lsma
褷	lhoo
褸	lllv
褹	lggi
褺	giyhv
褻	ygiv
褼	lmwu
褽	siyhv
褾	lmwf
褿	ltwa
襀	lqmc
襁	lnii
襁	lnri
襂	liih
襃	yhdv
襄	yrrv
襅	lwtj
襆	ltco
襇	lana
襈	lruc
襉	lanb
襊	lase
襋	ldbb
襌	lrrj
襍	logd
襎	lhdw
襏	lnoe
襐	lnao
襑	lsmi
襒	lfbk
襓	lggu
襔	ltlb
襕	llsw
襖	lhbk
襗	lwlj
襘	loma
襙	lrrd
襚	lyto
襛	ltwv
襜	lncr
襝	lomo
襞	sjyhv
襟	lddf
襠	lfbw
襡	lwli
襢	lywm
襣	lhul
襤	lsit
襥	loto
襦	lmbb
襧	lmfb
襨	ltgi
襩	lgwc
襪	ltwi
襫	lkma
襬	lwlp
襭	lgrc
襮	late
襯	lydu
襰	ldlc
襱	lybp
襲	ypyhv
襳	loim
襴	lanw
襵	lsjj
襶	ljic
襷	lhcq
襸	lhuc
襹	lmmp
襺	ltb'i
襻	lddq
襼	ltgi
襽	ltaw
襾	mub
西	mcw
覀	mllw
要	mwv
覂	mwhio
覃	mwaj
覄	mwoik
覅	mvphh
覆	mwhoe
覇	mbtjb
覈	mwhsk
覉	mbtjr
覊	mbtjf
見	buhu
覌	ebuu
覍	fbuu
覎	bund
規	qobuu
覐	bukk
覑	lnbuu
覒	hubuu
覓	bbuu
覔	mfbuu
覕	phbuu
視	ifbuu
覗	srbuu
覘	yrbuu
覙	nfbuu
覚	fbbuu
覛	hvbuu
覜	lmuou
覝	mfbuu
覞	bubuu
覟	gpbuu
覠	srbuu
覡	mobuu
覢	ffbuu
覣	hvbuu
覤	yubuu
覥	tcbuu
覦	onbuu
覧	sibuu
覨	rsbuu
覩	jabuu
親	ydbuu
覫	ysbuu
覬	utbuu
覭	bcbuu
覮	ffbbu
覯	tbbuu
覰	ymbuu
覱	jlbuu
覲	tmbuu
観	ogbuu
覴	ntbuu
覵	abbuu
覶	bbbuu
覷	ymbuu
覸	aabuu
覹	buhok
覺	hbbuu
覻	ytbuu
覼	mbbuu
覽	swbuu
覾	jwbuu
覿	gcbuu
觀	tgbuu
见	bhu
观	ebhu
觃	bund
规	qobhu
觅	bbhu
视	ifbhu
觇	yrbhu
览	libhu
觉	fbbhu
觊	uubhu
觋	mobhu
觌	jkbhu
觍	tcbhu
觎	onbhu
觏	tbbhu
觐	tmbhu
觑	ycbhu
角	nb'g
角	nb'q
觓	nbvl
觔	nbks
觕	hqnb'g
觖	nbdk
觗	nbhvp
觘	nbfh
觙	nbnhe
觚	nbhvo
觛	nbam
觜	ypnb'g
觜	ypnb'q
觝	nbhpm
觞	nbonh
觟	nbgg
觠	fqnb'g
觡	nbher
觢	qhnb'g
解	nbshq
觤	nbnmu
觥	nbfmu
触	nblmi
觧	nbtq
觨	nbme
觩	nbije
觪	nbytj
觫	nbdl
觬	nbhxu
觭	nbkmr
觮	nbvne
觯	nbcwj
觰	nbjka
觱	irnb'g
觲	nbtgq
觳	gbhne
觴	nboah
觵	nbtlc
觶	nbrrj
觷	hbnb'g
觸	nbwli
觹	nbogs
觺	ponb'g
觻	nbvid
觼	nbnbe
觽	nbuos
觾	nbtlf
觿	nbuob
言	ymmr
訂	yrmn
訃	yry
訄	knymr
訅	yrkn
訆	yrvl
訇	pymr
計	yrj
訉	yrhn'i
訊	yrnj
訋	yrpi
訌	yrm
訍	yre'i
討	yrdi
訏	yrmd
訐	yrmj
訑	yrpd
訒	yrshi
訓	yrlll
訔	uymr
訕	yru
訖	yron
託	yrhp
記	yrsu
訙	yrkni
訚	lsymr
訛	yrop
訜	yrcsh
訝	yrmvh
訞	yrhk
訟	yrci
訠	yrnl
訡	yroin
訢	yrhml
訣	yrdk
訤	yrkk
訥	yrob
訦	yrlbu
訧	yriku
訨	yrylm
訩	yru'k
訪	yryhs
訫	yrp
訬	yrfh
設	yrhne
訮	yrmt
訯	yrnhe
訰	yrpu
許	yroj
訲	yrl
訳	yrso
訴	yrhmy
訵	yrw'c
訶	yrmnr
訷	yrlwl
訸	yrhd
訹	yrijc
診	yrohh
註	yryg
証	yrmym
訽	yrpr
訾	ypymr
訿	yrymp
詀	yryr
詁	yrjr
詂	yrodi
詃	yryvi
詄	yrhqo
詅	yroii
詆	yrhpm
詇	yrlbk
詈	wlymr
詉	yrve
詊	yrfq
詋	yrrhu
詌	yrt'm
詍	yrpt
詎	yrss
詏	yrvis
詐	yros
詑	yrjp
詒	yrir
詓	yrgi
詔	yrshr
評	yrmfj
詖	yrdhe
詗	yrb'r
詘	yruu
詙	yrikk
詚	yram
詛	yrbm
詜	yrue
詝	yrjmn
詞	yrsmr
詟	ipymr
詠	yrine
詡	yrsmm
詢	yrpa
詣	yrpa
詤	yrvou
詥	yromr
試	yripm
詧	boymr
詨	yryck
詩	yrgdi
詪	yrav
詫	yrjhp
詬	yrhmr
詭	yrnmu
詮	yromg
詯	yrhbu
詰	yrgr
話	yrhjr
該	yryvo
詳	yrtq
詴	yrkb
詵	yrhgu
詶	yrill
詷	yrb'mr
詸	yrfd
詹	ncymr
詺	yrnir
詻	yrher
詼	yrkf
詽	yrmjj
詾	yrpu'k
詿	yrgg
誀	yrsj
誁	yrtt
誂	yrlmo
誃	yrnin
誄	yrqd
誅	yrhjd
誆	yrs'mg
誇	yrkms
誈	yrmig
誉	fcymr
誊	fqymr
誋	yrsup
誌	yrgp
認	yrsip
誎	yrdl
誏	yriav
誐	yrhqi
誑	yrkhg
誒	yriok
誓	qlymr
誔	yrnkg
誕	yrnkm
誖	yrjbd
誗	yrhdn
誘	yrhds
誙	yrmvm
誚	yrfb
誛	yrsme
誜	yrice
誝	yroir
語	yrmmr
誟	yrjkd
誠	yrihs
誡	yrit
誢	yrbuu
誣	yrmoo
誤	yrrvk
誥	yrhgr
誦	yrnib
誧	yrijb
誨	yrowy
誩	yrymr
說	yrcru
誫	yrmmv
読	yrgbu
誮	yrtop
誯	yraa
誰	yrog
誱	yrjlo
課	yrwd
誳	yrsuu
誴	yrjmf
誵	yrkkb
誶	yryoj
誷	yrb'tv
誸	yrnyi
誹	yrlmy
誺	yrdoo
誻	yrea
誼	yrjbm
誽	yrhxu
誾	anymr
調	yrb'gr
諀	yrhwj
諁	yreee
諂	yrnhx
諃	yrdd
諄	yryrd
諅	tcymr
諆	yrtmc
談	yrff
諈	yrhjm
諉	yrhdv
諊	yrpfd
請	yrqmb
諌	yrdw
諍	yrbsd
諎	yrta
諏	yrsje
諐	ouymr
諑	yrmso
諒	yryrf
諓	yrii
諔	yryfe
諕	yrypu
論	yromb
諗	yroip
諘	yrqmv
諙	yrhpa
諚	yrjmo
諛	yrhxo
諜	yrptd
諝	yrnob
諞	yrhsb
諟	yramo
諠	yrjmm
諡	yrcmt
諢	yrbjj
諣	yrbb'r
諤	yrrrs
諥	yrhjg
諦	yrybb
諧	yrppa
諨	yrmrw
諩	yrttc
諪	yryrn
諫	yrdw'f
諬	huymr
諭	yromn
諮	yrmor
諯	yrumb
諰	yrwp
諱	yrdmq
諲	yrmwg
諳	yryta
諴	yrihr
諵	yrjb'j
諶	yrtmv
諷	yrhn'i
諸	yrjka
諹	yramh
諺	yrykh
諻	yrhag
諼	yrbme
諽	yrtlj
諾	yrtkr
諿	yrrsj
謀	yrtmd
謁	yrapv
謂	yrwb
謃	yrahm
謄	bfqr
謅	yrpuu
謆	yrhsm
謇	jtcr
謈	atcr
謉	yrhui
謊	yrtyu
謋	yrnqd
謌	yrmrr
謍	ffbyr
謎	yryfd
謏	yrhxe
謐	yrpht
謑	yrbvk
謒	yroir
謓	yrjbc
謔	yrypm
謕	yrhyu
謖	yrwce
謗	yrybs
謘	yrsyj
謙	yrtxc
謚	yrtct
講	yrttb
謜	yrmhf
謝	yrhhi
謞	yryrb
謟	yrbhx
謠	yrbou
謡	yrbou
謢	yroge
謣	yrmbs
謤	yrmwf
謥	yrhwp
謦	geymr
謧	yryub
謨	yrtak
謩	takr
謪	yrycb
謫	yrycb
謬	yrsmh
謭	yrtbh
謮	yrqmc
謯	yrypm
謰	yryjj
謱	yrllv
謲	yriih
謳	yrs'rr
謴	yrwjc
謵	yrsma
謶	yritf
謷	gkymr
謸	yrgsk
謹	yrtlm
謺	giymr
謻	yrhdn
謼	yrypd
謽	niymr
謾	yrawe
謿	yrjjb
譀	yrmjk
譁	yrtmj
譂	yrrrj
譃	yrypm
譄	yrcwa
譅	yrsim
譆	yrgrr
譇	yrkja
譈	yrydk
證	yrnot
譊	yrggu
譋	yranb
譌	yrbhf
譍	iogr
譎	yrnhb
譏	yrvii
譐	yrtwi
譑	yrhkb
譒	yrhdw
譓	yrjip
譔	yrruc
譕	yrotf
譖	yrmua
譗	yrhor
識	yryia
譙	yrogf
譚	yrmwj
譛	yrqoa
譜	yrtca
譝	yrrxu
譞	yrwlv
譟	yrrrd
譠	yrywm
譡	yrfbw
譢	yryto
譣	yromo
譤	yrhsk
譥	hkymr
警	tkymr
譧	yritc
譨	yrtwv
譩	yrytp
譪	yrtav
譫	yrncr
譬	sjymr
譭	yrhge
譮	yroma
譯	yrwlj
議	yrtgi
譱	tqyrr
譲	yrycv
譳	yrmbb
譴	yrylr
譵	yrtgi
譶	yryrr
護	yrtoe
譸	yrgni
譹	yryro
譺	yrpko
譻	bcymr
譼	swymr
譽	hcymr
譾	yrtbm
譿	yrqjp
讀	yrgwc
讁	yryyb
讂	yrnbe
讃	yrqoc
讄	yrwww
讅	yrjhw
讆	hnymr
讇	yranx
讈	yrmhm
讉	yrylc
變	vfok
讋	ypymr
讌	yrtlf
讍	yrmgr
讎	ogyrg
讏	hnymr
讐	ogymr
讑	yromb
讒	yrnri
讓	yryrv
讔	yrnlp
讕	yranw
讖	yroim
讗	yruob
讘	yrsjj
讙	yrtrg
讚	yrhuc
讛	yrtgi
讜	yrfbf
讝	yrrrk
讞	yrybk
讟	yrgcr
计	ivj
订	ivmn
讣	ivy
认	ivo
讥	ivhn
讦	ivmj
讧	ivm
讨	ivdi
让	ivym
讪	ivu
讫	ivon
讬	ivhp
训	ivlll
议	ivik
讯	ivnj
记	ivsu
讱	ivshi
讲	ivtt
讳	ivqs
讴	ivs'k
讵	ivss
讶	ivmvh
讷	ivob
许	ivoj
讹	ivop
论	ivop
讻	ivuk
讼	ivci
讽	ivhn'k
设	ivhne
访	ivyhs
诀	ivdk
证	ivmym
诂	ivjr
诃	ivmnr
评	ivmfj
诅	ivbm
识	ivrc
诇	ivb'r
诈	ivos
诉	ivhmy
诊	ivohh
诋	ivhvi
诌	ivnsm
诌	ivns'm
词	ivsmr
诎	ivuu
诏	ivshr
诐	ivdhe
译	iveq
诒	ivir
诓	ivs'mg
诔	ivqd
试	ivipm
诖	ivgg
诗	ivgdi
诘	ivgr
诙	ivkf
诚	ivihs
诛	ivhjd
诜	ivhgu
话	ivhjr
诞	ivnkv
诟	ivhmr
诠	ivomg
诡	ivnmu
询	ivpa
诣	ivpa
诤	ivnsd
该	ivyvo
详	ivtq
诧	ivjhp
诨	ivbkq
诩	ivsmm
诪	ivqki
诫	ivit
诬	ivmoo
语	ivmmr
诮	ivfb
误	ivrmk
诰	ivhgr
诱	ivhds
诲	ivowy
诳	ivkhg
说	ivcru
诵	ivnib
诶	iviok
请	ivqmb
诸	ivjka
诹	ivsje
诺	ivtkr
读	ivjnk
诼	ivmso
诽	ivlmy
课	ivwd
诿	ivhdv
谀	ivhxo
谁	ivog
谂	ivoip
调	ivb'gr
谄	ivnhx
谅	ivyrf
谆	ivyrd
谇	ivyoj
谈	ivff
谉	ivjll
谊	ivjbm
谋	ivtmd
谌	ivtmv
谍	ivptd
谎	ivtyu
谏	ivdw'f
谐	ivppa
谑	ivypm
谒	ivapv
谓	ivwb
谔	ivrrs
谕	ivomn
谖	ivbme
谗	ivnuy
谘	ivior
谙	ivyta
谚	ivyhh
谛	ivybb
谜	ivyfd
谝	ivisb
谞	ivnob
谟	ivtak
谠	ivfbu
谡	ivwce
谢	ivhhi
谣	ivbou
谤	ivybs
谥	ivtct
谦	ivtxc
谧	ivpht
谨	ivtlm
谩	ivawe
谪	ivycb
谫	ivtbh
谬	ivsmh
谭	ivmwj
谮	ivmua
谯	ivogf
谰	ivlsw
谱	ivtca
谲	ivnhb
谳	ivjbk
谴	ivylr
谵	ivncr
谶	ivoim
谷	cor
谸	hjcor
谹	crki
谺	crmvh
谻	crnq
谼	crtc
谽	croir
谾	crjcm
谿	bkcor
豀	crbvk
豁	jrcor
豂	crsmh
豃	crmjk
豄	crgwc
豅	crybp
豆	mrt
豇	mtm
豈	umrt
豉	mtje
豊	twmrt
豋	bomrt
豌	mtjnu
豍	mthwj
豎	semrt
豏	mttxc
豐	ujmrt
豑	ttcnh
豒	utcnh
豓	utkit
豔	utgit
豕	msho
豖	msko
豗	mumso
豘	mopu
豙	ytpo
豚	bmso
豛	mohne
豜	momt
豝	moau
豞	mopr
豟	mohsn
豠	mobm
象	napo
豢	fqmso
豣	momjj
豤	moav
豥	moyvo
豦	ypmso
豧	moijb
豨	mokkb
豩	momso
豪	yrbo
豫	nnnao
豬	mojka
豭	morse
豮	mojto
豯	mobvk
豰	gohne
豱	mowot
豲	momhf
豳	u'moo
豴	moycb
豵	mohoo
豶	mojtc
豷	mogbt
豸	bshh
豹	bhpi
豺	bhdh
豻	bhmj
豼	bhpp
豽	bhob
豾	bhmfm
豿	bhpr
貀	bhuu
貁	bhjc
貂	bhshr
貃	bhha
貄	bhlq
貅	bhod
貆	bhmam
貇	bhav
貈	bhhby
貉	bhher
貊	bhma
貋	bhamj
貌	bhhau
貍	bhwg
貎	bhhxu
貏	bhhwj
貐	bhomn
貑	bhrse
貒	bhumb
貓	bhtw
貔	bhhwp
貕	bhbvk
貖	bhtct
貗	bhllv
貘	bhtak
貙	bhs'rr
貚	bhrrj
貛	bhtrg
貜	bhbue
貝	buc
貞	ybuc
貟	ibuc
負	nbuc
財	bcdh
貢	mbuc
貣	ipbuc
貤	bcpd
貥	bcyhn
貦	bcmmu
貧	cshc
貨	opbuc
販	bche
貪	oinc
貫	wjbuc
責	qmbuc
貭	hjbc
貮	mpbuc
貯	bcjmn
貰	ptbuc
貱	bcdhe
貲	ypbuc
貳	ipmmc
貴	lmbuc
貵	ikbuc
貶	bchio
買	wlbuc
貸	opbuc
貹	bchqm
貺	bcrhu
費	lnbuc
貼	bcyr
貽	bcir
貾	bchpm
貿	hhbuc
賀	krbuc
賁	jtbc
賂	bcher
賃	ogbuc
賄	bckb
賅	bcyvo
賆	bctt
資	mobuc
賈	mwbuc
賉	bchbt
賊	bcij
賋	bcyck
賌	yvoc
賍	bcig
賎	bciq
賏	bcbuc
賐	bcice
賑	bcmmv
賒	bcomf
賓	jmhc
賔	jahc
賕	bcije
賖	bcomd
賗	bcll
賘	bcigi
賙	bcb'gr
賚	dobuc
賛	qobuc
賜	bcaph
賝	bcbcd
賞	fbrbc
賟	bctbc
賠	bcytr
賡	iloc
賢	sebuc
賣	gwlc
賤	bcii
賥	bcyoj
賦	bcmpm
賧	bcff
賨	jmmc
賩	bcjmf
質	hlbuc
賫	jbbuc
賬	bcsmv
賭	bcjka
賮	lmfbc
賯	bcpad
賰	bcqka
賱	bcbjj
賲	odbuc
賳	bcjir
賴	dlshc
賵	bcabu
賶	bcoir
賷	jbbuc
賸	bfqc
賹	bctct
賺	bctxc
賻	bcibi
購	bcttb
賽	jtcc
賾	slqmc
賿	bcsmh
贀	sebuc
贁	bcok
贂	bciih
贃	bcllp
贄	gibuc
贅	gkbuc
贆	bcikk
贇	ymbuc
贈	bccwa
贉	bcmwj
贊	hubuc
贋	mogc
贌	bctco
贍	bcncr
贎	bctwb
贏	ynbuc
贐	bclmt
贑	yjmbc
贒	spbuc
贓	bcims
贔	bcbcc
贕	hhslc
贖	bcgwc
贗	mofc
贘	bcfbc
贙	yubuc
贚	bcybp
贛	yjhec
贜	bctis
贝	bo
贞	ybo
负	nbo
贠	ibo
贡	mbo
财	bodh
责	qmbo
贤	lebo
败	book
账	bopo
货	opbo
质	hjbo
贩	bohe
贪	oino
贫	csho
贬	bohio
购	bopi
贮	bojm
贯	wjbo
贰	ipmmo
贱	boij
贲	jtbo
贳	ptbo
贴	boyr
贵	lmbo
贶	borhu
贷	opbo
贸	hhbo
费	lnbo
贺	krbo
贻	boir
贼	boij
贽	qibo
贾	mwbo
贿	bokb
赀	ypbo
赁	ogbo
赂	boher
赃	boig
资	iobo
赅	boyvo
赆	bosoy
赇	boije
赈	bommv
赉	dtbo
赊	boomf
赋	bompm
赌	bojka
赍	jbbo
赎	bojnk
赏	fbrbo
赐	boaph
赑	boboo
赒	bob'gr
赓	iloo
赔	boytr
赕	boff
赖	dlnbo
赗	boabu
赘	qkbo
赙	boibi
赚	botxc
赛	jtco
赜	slqmo
赝	mogo
赞	hubo
赟	ymbo
赠	bocwa
赡	boncr
赢	ynbo
赣	yjheo
赤	glnc
赥	gcno
赦	gcok
赧	gcsle
赨	gclmi
赩	gcnau
赪	gcybo
赫	gcglc
赬	gcybc
赭	gcjka
赮	gcrse
赯	gcilr
走	gyo
赱	gco
赲	goks
赳	govl
赴	goy
赵	gok
赶	gomj
起	goru
起	gosu
赸	gou
赹	gopmm
赺	gooin
赻	gofh
赼	gono
赽	godk
赾	gohml
赿	gohvp
趀	golxh
趁	goohh
趂	gonf
趃	gohqo
趄	gobm
超	goshr
趆	gohpm
趇	goyt
趈	goyr
趉	gouu
越	goiv
趋	gonsm
趋	gons'm
趌	gogr
趍	gonin
趎	gohjd
趏	gohjr
趐	gosmm
趑	goimo
趑	gommo
趒	golmo
趓	gohnd
趔	gomnn
趕	goamj
趖	gooog
趗	goryo
趘	goshu
趙	gofb
趚	godl
趛	goc
趜	gopfd
趝	gooip
趞	gota
趟	gofb'r
趠	goyaj
趡	goog
趢	govne
趣	gosje
趤	gojmr
趥	gotcw
趦	goior
趧	goamo
趨	gopuu
趩	gowtc
趪	gotlc
趫	gohkb
趬	goggu
趭	googf
趮	gorrd
趯	gosmg
趰	gomfb
趱	gohuo
趲	gohuc
足	ryo
趴	rmc
趵	rmpi
趶	rmmd
趷	rmon
趸	msryo
趹	rmdk
趺	rmqo
趻	rmoin
趼	rmmt
趽	rmyhs
趾	rmylm
趿	rmnhe
跀	rmb
跁	rmau
跂	rmje
跃	rmhk
跄	rmosu
跅	rmhmy
跆	rmir
跇	rmpt
跈	rmohh
跉	rmoii
跊	rmjd
跋	rmike
跋	rmikk
跌	rmhqo
跍	rmjr
跎	rmjp
跏	rmksr
跐	rmymp
跑	rmpru
跒	rmmnr
跓	rmyg
跔	rmpr
跕	rmyr
跖	rmmr
跗	rmodi
跘	rmfq
跙	rmbm
跚	rmbbm
跚	rmbt
跛	rmdhe
跜	rmsp
距	rmss
跞	rmhvd
跟	rmav
跠	rmkn
跡	rmylc
跢	rmnin
跣	rmhgu
跤	rmyck
跥	rmnsd
跦	rmhjd
跧	rmomg
跨	rmkms
跩	rmlwp
跪	rmnmu
跫	mnryo
跬	rmgg
跭	rmheq
跮	rmmig
路	rmher
跰	rmtt
跱	rmgdi
跲	rmomr
跳	rmlmo
跴	rmmcw
践	rmij
跶	rmyk
跷	rmjpu
跸	rmppj
跹	rmyhj
跺	rmhnd
跻	rmykl
跼	rmss'r
跽	rmsup
跾	okryo
跿	rmgyo
踀	rmryo
踁	rmmvm
踂	rmsju
踃	rmfb
踄	rmylh
踅	qlryo
踆	rmice
踇	rmowy
踈	rmdl
踉	rmiav
踊	rmnib
踋	rmgil
踌	rmqki
踍	rmjkd
踎	rmmfr
踏	rmea
踐	rmii
踑	rmtmc
踒	rmhdv
踓	rmog
踔	rmyaj
踕	rmjlo
踖	rmta
踗	rmoip
踘	rmpfd
踙	rmsje
踚	rmomb
踛	rmgcg
踜	rmgce
踝	rmwd
踞	rmsjr
踟	rmokr
踠	rmjnu
踡	rmfqu
踢	rmaph
踣	rmytr
踤	rmyoj
踥	rmytv
踦	rmkmr
踧	rmyfe
踨	rmooo
踩	rmbd
踪	rmjmf
踫	rmttc
踬	rmhjo
踭	rmnsd
踮	rmiyr
踯	rmtkl
踰	rmomn
踱	rmite
踲	rmhju
踳	rmqka
踴	rmnbs
踵	rmhjg
踶	rmamo
踷	rmjka
踸	rmtmv
踹	rmumb
踺	rmnkq
踻	rmbb'r
踼	rmamh
踽	rmhlb
踾	rmmrw
踿	rmhdf
蹀	rmptd
蹁	rmhsb
蹁	rmisb
蹂	rmnhd
蹃	rmtkr
蹄	rmybb
蹅	rmdam
蹆	rmyav
蹇	jtco
蹈	rmbhx
蹉	rmtqm
蹊	rmbvk
蹋	rmasm
蹌	rmoir
蹍	rmstv
蹎	rmjbc
蹏	rmhyn
蹐	rmfcb
蹑	rmsje
蹒	rmtmb
蹓	rmhhw
蹔	jlryo
蹕	rmwtj
蹖	rmqkx
蹗	rmixp
蹘	rmsmh
蹙	ifryo
蹚	rmfbg
蹛	rmkpb
蹜	rmjoa
蹝	rmhoo
蹞	rmpmc
蹟	rmqmc
蹠	rmitf
蹡	rmvmi
蹢	rmycb
蹣	rmtlb
蹤	rmhoo
蹥	rmyjj
蹦	rmubb
蹧	rmtwa
蹨	rmbkf
蹩	fkryo
蹪	rmlmc
蹫	rmnhb
蹬	rmnot
蹭	rmcwa
蹮	rmmwu
蹯	rmhdw
蹰	rmmmi
蹱	rmytg
蹲	rmtwi
蹳	rmnoe
蹴	rmyfu
蹵	yuryo
蹶	rmmto
蹷	moryo
蹸	rmfdq
蹹	rmorm
蹺	rmggu
蹻	rmhkb
蹼	rmtco
蹽	rmkcf
蹾	rmydk
蹿	rmjcl
躀	rmwjc
躁	rmrrd
躂	rmygq
躃	rmsrj
躄	sjryo
躅	rmwli
躆	rmypo
躇	rmtja
躈	rmhsk
躉	twbo
躊	rmgni
躋	rmyx
躌	rmotq
躍	rmsmg
躎	rmmfb
躏	rmtlg
躐	rmvvv
躑	rmtkl
躒	rmvid
躓	rmhlc
躔	rmiwg
躕	rmigi
躖	rmvim
躗	hnryo
躘	rmybp
躙	rmang
躚	rmymu
躛	hnryo
躜	rmhuo
躝	rmanw
躞	rmffe
躟	rmyrv
躠	tjryo
躡	rmsjj
躢	rmanm
躣	rmbug
躤	rmtqa
躥	rmjcv
躦	rmhuc
躧	rmmmp
躨	rmtce
躩	rmbue
躪	rmtag
身	hxh
躬	hhn
躭	hhlbu
躮	hhcsh
躯	hhs'k
躰	hhdm
躱	hhnsd
躲	hhhnd
躳	hhrhr
躴	hhiav
躵	hhsip
躶	hhwd
躷	hhhdv
躸	hhkmr
躹	hhpfd
躺	hhfb'r
躻	hhjcm
躼	hhsmv
躽	hhs'av
躾	hhtgk
躿	hhile
軀	hhs'rr
軁	hhllv
軂	hhffs
軃	hhrrj
軄	hhyia
軅	hhmog
軆	hhtwt
軇	hhgni
軈	hhiop
軉	hhjmc
車	jwj
軋	jju
軌	jjkn
軍	bjwj
軎	jjr
軏	jjmu
軐	jjnj
軑	jjk
軒	jjmj
軓	jjhn'i
軔	jjshi
軕	jju
軖	jjmg
軗	jjhne
軘	jjpu
軙	jjye
軚	jjki
軛	jjmsu
軜	jjob
軝	jjhvp
軞	jjhqu
軟	jjno
軠	jjhg
軡	jjoin
転	jjmmi
軣	jjimo
軤	jjhfd
軥	jjpr
軦	jjrhu
軧	jjhpm
軨	jjoii
軩	jjir
軪	jjvis
軫	jjohh
軬	ikjwj
軭	jjs'mg
軮	jjlbk
軯	jjmfj
軰	lpjwj
軱	jjhvo
軲	jjjr
軳	jjpru
軴	jjyg
軵	jjodi
軶	jjhsn
軷	jjikk
軸	jjlw
軹	jjrc
軺	jjshr
軻	jjmnr
軼	jjhqo
軽	jjeg
軾	jjipm
軿	jjtt
輀	jjmb'l
輁	jjtc
輂	tcjwj
較	jjyck
輄	jjfmu
輅	jjher
輆	jjyvo
輇	jjomg
輈	jjhby
載	jijwj
輊	jjmig
輋	ukjj
輌	jjmub
輍	jjcor
輎	jjfb
輏	jjmcw
輐	jjjmu
輑	jjskr
輒	jjsju
輓	jjnau
輔	jjijb
輕	jjmvm
輖	jjb'gr
輗	jjhxu
輘	jjgce
輙	jjsje
輚	jjii
輛	jjmlb
輜	jjvvw
輝	fubjj
輞	jjb'tv
輟	jjeee
輠	jjwd
輡	jjnhx
輢	jjkmr
輣	jjbb
輤	jjqmb
輥	jjapp
輦	qojwj
輧	jjytt
輨	jjjrr
輩	lyjwj
輪	jjomb
輫	jjlmy
輬	jjyrf
輭	jjmbk
輮	jjnhd
輯	jjrsj
輰	jjamh
輱	jjihr
輲	jjumb
輳	jjqkk
輴	jjhju
輵	jjapv
輶	jjtcw
輷	jjpyr
輸	jjomn
輹	jjoae
輺	jjvmw
輻	jjmrw
輼	jjabt
輽	jjikw
輾	jjstv
輿	hxjc
轀	jjwot
轁	jjbhx
轂	gjhne
轃	jjqkd
轄	jjjqr
轅	jjgrv
轆	jjixp
轇	jjsmh
轈	jjvvd
轉	jjjii
轊	jjqjs
轋	jjyjj
轌	jjmbs
轍	jjybk
轎	jjhkb
轏	jjsnd
轐	jjtco
轑	jjkcf
轒	jjjtc
轓	jjhdw
轔	jjfdq
轕	jjtav
轖	jjgow
轗	jjirp
轘	jjwlv
轙	jjtgi
轚	jejwj
轛	jjtgi
轜	jjmbb
轝	hcjwj
轞	jjsit
轟	jjjjj
轠	jjwww
轡	vfr
轢	jjvid
轣	jjmhm
轤	jjypt
轥	jjtag
车	kq
轧	kqu
轨	kqkn
轩	kqmj
轪	kqk
轫	kqshi
转	kqqni
轭	kqmsu
轮	kqop
软	kqno
轰	kqee
轱	kqjr
轲	kqmnr
轳	kqys
轴	kqlw
轵	kqrc
轶	kqhqo
轷	kqhfd
轸	kqohh
轹	kqhvd
轺	kqshr
轻	kqnom
轼	kqipm
载	jikq
轾	kqmig
轿	kqhkl
辀	kqhby
辁	kqomg
辂	kqher
较	kqyck
辄	kqsju
辅	kqijb
辆	kqmob
辇	qokq
辈	lykq
辉	fubkq
辉	fvbkq
辊	kqapp
辋	kqb'tv
辌	kqyrf
辍	kqeee
辎	kqvvw
辏	kqqkk
辐	kqmrw
辑	kqrsj
辒	kqabt
输	kqomn
辔	vmr
辕	kqgrv
辖	kqjqr
辗	kqstv
辘	kqixp
辙	kqybk
辚	kqfdq
辛	ytj
辜	jrytj
辝	irytj
辞	hrytj
辟	srytj
辠	huytj
辡	yjytj
辢	dlytj
辣	yjdl
辤	beytj
辥	urytj
辦	yjksj
辧	yjshj
辨	yjilj
辩	yjivj
辪	yrytj
辫	yjvmj
辬	yjykj
辭	bbytj
辮	yjvfj
辯	yjyrj
辰	mmmv
辱	mvdi
農	twmmv
辳	ddmmv
辴	rjmmv
辵	hhho
辷	ym
辸	ynhs
边	yks
辺	ysh
辻	yj
込	yo
辽	ynn
达	yk
辿	yu
迀	ymj
迁	yhj
迂	ymd
迃	ymms
迄	yon
迅	ynj
迆	ypd
过	ydi
迈	yms
迉	ys
迊	ymlb
迋	ymg
迌	yb
迍	ypu
迎	yhvl
迏	yki
运	ymmi
近	yhml
迒	yyhn
迓	ymvh
返	yhe
迕	yoj
迖	yik
迗	ymk
还	ymf
这	yyk
迚	yl
进	ytt
远	ymmu
违	yqs
连	ykq
迟	yso
迠	yyr
迡	ysp
迢	yshr
迣	ypt
迤	yopd
迥	yb'r
迦	yksr
迧	ylwl
迨	yir
迩	ynf
迪	ylw
迫	yha
迬	yyg
迭	yhqo
迮	yos
迯	yniy
述	yid
述	yijc
迱	yjp
迲	ygi
迳	ynom
迴	yw'r
迵	yb'mr
迶	ykb
迷	yfd
迸	ytt
迹	yylc
迺	ymcw
迻	ynin
迼	ygr
追	yhrr
迾	ymnn
迿	ypa
退	yav
送	ytk
适	yhjr
逃	ylmo
逄	yheq
逅	yhmr
逆	ytu
逇	ygpd
逈	yhb'r
选	yhgu
逊	yndf
逋	yijb
逌	yyw's
逍	yfb
逎	ymcw
透	yhds
逐	ymso
逑	yije
递	ycnh
逓	yhqb
途	yomd
逕	ymvm
逖	ykhf
逗	ymrt
逘	yiok
這	yymr
通	ynib
逛	ykhg
逜	ymmr
逝	yqhl
逞	yrhg
逞	yrmg
速	ydl
造	yhgr
逡	yice
逢	yhej
連	yjwj
逤	yefh
逥	yw'sl
逦	ymbb
逧	ycor
逨	ydoo
逩	ykjt
逪	yta
逫	yeee
逬	yytt
逭	yjrr
逮	yle
逯	ynme
逯	yvne
逰	yqod
週	yb'gr
進	yog
逳	yyib
逴	yyaj
逵	ygcg
逶	yhdv
逷	yaph
逸	ynai
逹	ygtj
逺	ygvv
逻	ywln
逼	ymrw
逽	ytkr
逾	yomn
逿	yamh
遀	ykmb
遁	yhju
遂	ytpo
遃	yyhh
遄	yumb
遅	ystq
遆	yybb
遇	ywlb
遈	yamo
遉	yybc
遊	yysd
運	ybjj
遌	yrrs
遍	yhsb
遍	yisb
過	ybb'r
遏	yapv
遐	yrse
遑	yhag
遒	ytcw
道	ythu
達	ygtq
違	ydmq
遖	yjb'j
遗	ylmo
遘	yttb
遙	ybou
遚	yhxe
遛	yhhw
遜	yndf
遝	ywle
遞	yhyu
遟	ysyj
遠	ygrv
遡	ytub
遢	yasm
遣	ylmr
遤	ysqf
遥	ybou
遦	ywjc
遧	yytj
遨	ygsk
遨	yqsk
適	yycb
遪	yiih
遫	ydlk
遬	ydlo
遭	ytwa
遮	yitf
遯	ybmo
遰	ykpb
遱	yllv
遲	yseq
遳	ytog
遴	yfdq
遵	ytwi
遶	yggu
遷	ymwu
選	yruc
遹	ynhb
遺	ylmc
遻	yrru
遼	ykcf
遽	yypo
遾	yhmo
避	ysrj
邀	yhsk
邁	ytwb
邂	ynbq
邃	yjco
還	ywlv
邅	yywm
邆	ynot
邇	ymfb
邈	ybhu
邉	yhur
邊	yhus
邋	yvvv
邌	yhhe
邍	yhwe
邎	ybrf
邏	ywlg
邐	ymmp
邑	rau
邒	mnnl
邓	enl
邔	sunl
邕	vvrau
邖	unl
邗	mjnl
邘	mdnl
邙	yvnl
邚	vnl
邛	mnl
邜	ninl
邝	inl
邞	qonl
邟	ynnl
邠	chnl
邡	ysnl
邢	mtnl
那	sqnl
邤	hlnl
邥	lunl
邦	qjnl
邧	munl
邨	punl
邩	fnl
邪	mhnl
邫	qjrau
邬	pmnl
邭	prnl
邮	lwnl
邯	tmnl
邰	irnl
邱	omnl
邲	phnl
邳	mmnl
邴	mbnl
邵	srnl
邶	lmpnl
邷	mnnl
邸	hinl
邸	hmnl
邹	nsnl
邺	tcnl
邻	oinl
邼	sgnl
邽	ggnl
邾	hdnl
邿	ginl
郀	ksnl
郁	kbnl
郂	yonl
郃	ornl
郄	kinl
郅	mgnl
郆	grnl
郇	panl
郈	hrnl
郉	mjmjl
郊	yknl
郋	hunl
郌	ggrau
郍	hynl
郎	iinl
郏	ktnl
郐	oinl
郑	tknl
郒	iirau
郓	bqnl
郔	nmnl
郕	isnl
郖	mtnl
郗	kbnl
郘	rrnl
郙	ibnl
郚	mrnl
郛	bdnl
郜	hrnl
郝	gcnl
郞	ivnl
郟	konl
郠	mknl
郡	srnl
郢	rgnl
郣	jdnl
郤	crnl
郥	bcnl
郦	mbnl
郧	ronl
部	yrnl
郩	kbnl
郪	jvnl
郫	hjnl
郬	qbnl
郭	ydnl
郮	brnl
郯	ffnl
郰	sjenl
郱	ttnl
郲	donl
郳	hunl
郴	ddnl
郵	hmnl
郶	yrrau
郷	vhail
郸	cjnl
郹	bknl
郺	nnvvu
郻	bvnl
郼	dqnl
都	janl
郾	svnl
郿	aunl
鄀	trnl
鄁	lbnl
鄂	rsnl
鄃	onnl
鄄	mgnl
鄅	hbnl
鄆	bjnl
鄇	onkl
鄈	nknl
鄉	vhiil
鄊	vhsjl
鄋	henl
鄌	irnl
鄍	bcnl
鄎	hpnl
鄏	minl
鄐	ywnl
鄑	manl
鄒	punl
鄓	hknl
鄔	hfnl
鄕	vhhpl
鄖	rcnl
鄗	ybnl
鄘	ibnl
鄙	rwnl
鄚	tknl
鄛	vdnl
鄜	ipnl
鄝	shnl
鄞	tmnl
鄟	jinl
鄠	msnl
鄡	hdnl
鄢	mfnl
鄣	yjnl
鄤	aenl
鄥	hfnl
鄦	ofnl
鄧	ntnl
鄨	fkrau
鄩	sinl
鄪	lcnl
鄫	canl
鄬	ifnl
鄭	tknl
鄮	hcnl
鄯	trnl
鄰	fqnl
鄱	hwnl
鄲	rjnl
鄳	runl
鄴	tdnl
鄵	rdnl
鄶	oanl
鄷	ttnl
鄸	tnnl
鄹	sonl
鄺	icnl
鄻	qjnl
鄼	qcnl
鄽	ignl
鄾	menl
鄿	tjnl
酀	tfnl
酁	ninl
酂	honl
酃	mrnl
酄	tgnl
酅	ubnl
酆	utnl
酇	hcnl
酈	mpnl
酉	mcw'm
酊	mwmn
酋	tcw'm
酌	mwpi
配	mwsu
酎	mwdi
酏	mwpd
酐	mwmj
酑	mwmd
酒	emcw
酓	oinw
酔	mwknj
酕	mwhqu
酖	mwlbu
酗	mwu'k
酘	mwhne
酙	mwyj
酚	mwcsh
酛	mwmmu
酜	mwqo
酝	mwmmi
酞	mwki
酟	mwyr
酠	mwmnr
酡	mwjp
酢	mwos
酣	mwt'm
酤	mwjr
酥	mwhd
酦	mwive
酧	mwjdi
酨	jimcw
酩	mwnir
酪	mwher
酫	mwomg
酬	mwill
酭	mwkb
酮	mwb'mr
酯	mwpa
酰	mwhgu
酱	lnmcw
酲	mwrhg
酲	mwrmg
酳	mwvib
酴	mwomd
酵	mwjkd
酶	mwowy
酷	mwhgr
酸	mwice
酹	mwbdi
酺	mwijb
酻	mwbnd
酼	mwyiu
酽	mwmth
酾	mwmbb
酿	mwiav
醀	mwog
醁	mwvne
醂	mwdd
醃	mwklu
醄	mwpou
醅	mwytr
醆	mwii
醇	mwyrd
醈	mwff
醉	mwyoj
醊	mweee
醋	mwta
醌	mwapp
醍	mwamo
醎	mwihr
醏	mwjka
醐	mwjrb
醑	mwnob
醒	mwahm
醓	mwlut
醔	hfmcw
醕	mwyra
醖	mwabt
醗	mwnop
醘	mwgit
醙	mwhxe
醚	mwyfd
醛	mwtog
醜	mwhui
醝	mwtqm
醞	mwwot
醟	ffb'mw
醠	mwlkt
醡	mwjcs
醢	mwkrt
醣	mwilr
醤	limcw
醥	mwmwf
醦	mwiih
醧	mws'rr
醨	mwyub
醩	mwtwa
醪	mwsmh
醫	semcw
醬	vimcw
醭	mwtco
醮	mwogf
醯	mwyit
醰	mwmwj
醱	mwnoe
醲	mwtwv
醳	mwwlj
醴	mwtwt
醵	mwypo
醶	mwomo
醷	mwytp
醸	mwycv
醹	mwmbb
醺	mwhgf
醻	mwgni
醼	mwtlf
醽	mwmbr
醾	mwicd
醿	mwidf
釀	mwyrv
釁	hbmch
釂	mwbwi
釃	mwmmp
釄	mwicy
釅	mwrrk
釆	hfd
采	bd
釈	hdso
釉	hdlw
释	hdeq
釋	hdwlj
里	wg
重	hjwg
野	wgnin
量	amwg
釐	jkmwg
金	c
釓	cu
釔	cn
釕	cnn
釖	csh
釗	cln
釘	cmn
釙	cy
釚	ckn
釛	cks
釜	ckmgc
針	cj
釞	co
釟	cc
釠	chn
釡	cc
釢	cnhs
釣	cpi
釤	chhh
釥	cf
釦	cr
釧	clll
釨	cnd
釩	chn'i
釪	cmd
釫	cmms
釬	cmj
釭	cm
釮	cdh
釯	cyv
釰	cshi
釱	ck
釲	cru
釳	con
釴	cip
釵	ce'i
釶	cpd
釷	cg
釸	cn'i
釹	cv
釺	chj
釻	ckni
釼	csk
釽	chlo
釾	cmvh
釿	chml
鈀	cau
鈁	cyhs
鈂	clbu
鈃	cmt
鈄	cyj
鈅	cb
鈆	cci
鈇	cqo
鈈	cmf
鈉	cob
鈊	cp
鈋	cop
鈌	cdk
鈍	cpu
鈎	cpi
鈏	cnl
鈐	coin
鈑	che
鈒	cnhe
鈓	chg
鈔	cfh
鈕	cng
鈖	ccsh
鈗	cihu
鈘	cje
鈙	cye
鈚	cpp
鈛	ci
鈜	cki
鈝	chq
鈞	cpmm
鈟	cnl
鈠	chne
鈡	cl
鈢	cd
鈣	cmys
鈤	ca
鈥	cf
鈦	cki
鈧	cyhn
鈨	cmmu
鈩	chs
鈪	cmsu
鈫	cyk
鈬	cso
鈭	ypc
鈮	csp
鈯	cuu
鈰	cylb
鈱	crvp
鈲	chvo
鈳	cmnr
鈴	coii
鈵	cmob
鈶	cir
鈷	cjr
鈸	cikk
鈹	cdhe
鈺	cmgi
鈻	crlr
鈼	cos
鈽	cklb
鈾	clw
鈿	cw
鉀	cwl
鉁	cohh
鉂	clk
鉃	cok
鉄	chqo
鉅	css
鉆	cyr
鉇	copd
鉈	cjp
鉉	cyvi
鉊	cshr
鉋	cpru
鉌	chd
鉍	cph
鉎	chqm
鉏	cbm
鉐	cmr
鉑	cha
鉒	cyg
鉓	colb
鉔	cs'lb
鉕	cs'r
鉖	chey
鉗	ct'm
鉘	clln
鉙	crc
鉚	chhl
鉛	ccr
鉜	codi
鉝	cyt
鉞	civ
鉟	cmfm
鉠	clbk
鉡	cfq
鉢	cdm
鉣	cgi
鉤	cpr
鉥	cijc
鉦	cmym
鉧	cwy'i
鉨	cnf
鉩	cof
鉪	cpt
鉫	cksr
鉬	cbu
鉭	cam
鉮	clwl
鉯	cvio
鉰	csmr
鉱	cii
鉲	cymy
鉳	clmp
鉴	lic
鉵	clmi
鉶	cmtn
鉷	ctc
鉸	cyck
鉹	cnin
鉺	csj
鉻	cher
鉼	ctt
鉽	cipm
鉾	cihq
鉿	comr
銀	cav
銁	cpa
銂	cill
銃	cyiu
銄	chb'r
銅	cb'mr
銆	cma
銇	cqd
銈	cgg
銉	clq
銊	cihm
銋	cohg
銌	ckld
銍	cmig
銎	mnc
銏	cbt
銐	mnc
銑	chgu
銒	cmjj
銓	comg
銔	cmfj
銕	ckn
銖	chjd
銗	chmr
銘	cnir
銙	ckms
銚	clmo
銛	chjr
銜	hocmn
銝	cod
銞	pac
銟	culb
銠	cjkp
銡	cgr
銢	cine
銣	cvr
銤	cfd
銥	cyhv
銦	cw'k
銧	cfmu
銨	cjv
銩	chgi
銪	ckb
銫	cnau
銬	cjks
銭	ciq
銮	ycc
銯	cvif
銰	ctk
銱	crlb
銲	camj
銳	ccru
銴	qlc
銵	chxh
銶	cije
銷	cfb
銸	csju
銺	vgc
銻	ccnh
銼	coog
銽	chpr
銾	cme
銿	cnib
鋀	cmrt
鋁	crhr
鋂	cowy
鋃	ciav
鋄	cmfe
鋅	cytj
鋆	gmc
鋇	cbuc
鋈	ekc
鋉	cdl
鋊	ccor
鋋	cnkm
鋌	cnkg
鋍	cjbd
鋎	cjmu
鋏	ckoo
鋐	cjki
鋑	cice
鋒	chej
鋓	chdn
鋔	cnau
鋕	cgp
鋖	cbv
鋗	crb
鋘	crvk
鋙	cmmr
鋚	okc
鋛	cll
鋜	cryo
鋝	cbdi
鋞	cmvm
鋟	csme
鋠	cmmv
鋡	coir
鋢	cbnd
鋣	cmhl
鋤	cbms
鋥	crmg
鋦	css'r
鋧	cbuu
鋨	chqi
鋩	ctyv
鋪	cijb
鋫	hnc
鋬	qec
鋮	cihs
鋯	chgr
鋰	cwg
鋱	cipp
鋲	comc
鋳	cqki
鋴	cjru
鋵	chdu
鋶	cyiu
鋷	csje
鋸	csjr
鋹	csmv
鋺	cjnu
鋻	sec
鋼	cb'tu
鋽	cyaj
鋾	cpou
鋿	cfb'r
錀	comb
錁	cwd
錂	cgce
錃	eec
錄	cvne
錅	hhc
錆	cqmb
錇	cytr
錈	cfqu
錉	chpa
錊	cyoj
錋	cbb
錌	cumj
錍	chwj
錎	cnhx
錏	cmlm
錐	cog
錑	chsk
錒	cnlr
錓	ctgu
錔	cea
錕	capp
錖	yec
錗	chdv
錘	chjm
錙	cvvw
錚	cbsd
錛	ckjt
錜	coip
錝	cjmf
錞	cyrd
錟	cff
錠	cjmo
錡	ckmr
錢	cii
錣	ceee
錤	ctmc
錥	cyib
錦	chab
錧	cjrr
錨	ctw
錩	caa
錪	ctbc
錫	caph
錬	cdw
錭	cb'gr
錮	cw'jr
錯	cta
錰	cdf
錱	cmgg
録	cnme
錳	cndt
錴	cgcg
錵	ctop
錶	cqmv
錷	cjju
錸	cdoo
錹	cymb
錺	ctys
錻	cmpm
錼	ckmf
錽	cmfe
錾	klc
錿	cypn
鍀	cami
鍁	chlo
鍂	cc
鍃	cphp
鍄	cyrf
鍅	cegi
鍆	can
鍇	cppa
鍈	ctlk
鍉	camo
鍊	cdw'f
鍋	cbb'r
鍌	euc
鍍	cite
鍎	chju
鍏	cdmq
鍐	cuce
鍑	coae
鍒	cnhd
鍓	crsj
鍔	crrs
鍕	cbjj
鍖	ctmv
鍗	cybb
鍘	cbcn
鍙	ecc
鍚	camh
鍛	chje
鍜	crse
鍝	cwlb
鍞	cybc
鍟	cahm
鍠	chag
鍡	cwmv
鍢	cmrw
鍣	ctsr
鍤	chjx
鍥	cqhk
鍦	cysd
鍧	cpyr
鍨	cnok
鍩	ctkr
鍪	nkc
鍫	hfc
鍬	chdf
鍭	conk
鍮	comn
鍯	cpkp
鍰	cbme
鍱	cptd
鍲	crpa
鍳	sic
鍴	cumb
鍵	cnkq
鍶	cwp
鍷	ckgg
鍸	cjrb
鍹	cjmm
鍺	cjka
鍻	capv
鍼	cihr
鍽	chsb
鍾	chjg
鍿	cvmw
鎀	colh
鎁	csjl
鎂	ctgk
鎃	cehv
鎄	cyrv
鎅	cwol
鎆	ctbn
鎇	cahu
鎈	ctqm
鎉	casm
鎊	cybs
鎋	cjqr
鎌	ctxc
鎍	cjbf
鎎	cond
鎏	euc
鎐	cbou
鎑	cgit
鎒	cmvi
鎓	ccim
鎔	cjcr
鎕	cilr
鎖	cfbc
鎗	coir
鎘	cmrb
鎙	ctub
鎚	cyhr
鎛	cibi
鎜	hec
鎝	ctor
鎞	chwp
鎟	ceed
鎠	cwlm
鎡	ctvi
鎢	chrf
鎣	ffbc
鎤	cafu
鎥	odc
鎦	chhw
鎧	cumt
鎨	cogj
鎩	ckce
鎪	chxe
鎫	chbe
鎬	cyrb
鎭	cpbc
鎮	cjbc
鎯	ciil
鎰	ctct
鎱	cgrv
鎲	cfbu
鎳	chud
鎴	chup
鎵	cjmo
鎶	cmrr
鎷	csqf
鎸	cogs
鎹	cytk
鎺	cifm
鎻	cvvc
鎼	cypq
鎽	cuhj
鎾	cwot
鎿	corq
鏀	cyw'i
鏁	cvvd
鏂	cs'rr
鏃	cysk
鏄	cjii
鏅	colb
鏆	cwjc
鏇	cyso
鏈	cyjj
鏉	cdlo
鏊	gkc
鏊	qkc
鏋	ctlb
鏌	ctak
鏍	cwvf
鏎	cwtj
鏏	cqjm
鏐	csmh
鏑	cycb
鏒	ciih
鏓	chwp
鏔	cjmc
鏕	cixp
鏖	ipc
鏗	cseg
鏘	cvmi
鏙	cuog
鏚	cihf
鏛	cfbb
鏜	cfbg
鏝	cawe
鏞	cilb
鏟	cykm
鏠	cyhj
鏡	cytu
鏢	cmwf
鏣	citf
鏤	cllv
鏥	cjoa
鏦	choo
鏧	gec
鏨	jlc
鏩	cjjl
鏪	ctwa
鏫	chnd
鏬	cypd
鏭	chdp
鏮	cile
鏯	ckkk
鏰	cubb
鏱	cytj
鏲	cyvq
鏳	ccwa
鏴	crmr
鏵	ctmj
鏶	cogd
鏷	ctco
鏸	cjip
鏹	cnii
鏺	cnoe
鏻	cfdq
鏼	chdb
鏽	clx
鏾	ctbk
鏿	cfbd
鐀	clmc
鐁	ctcl
鐂	cmlw
鐃	cggu
鐄	ctlc
鐅	fkc
鐆	noc
鐇	chdw
鐈	chkb
鐉	cruc
鐊	cnlh
鐋	ceah
鐌	cnao
鐍	cnhb
鐎	cogf
鐏	ctwi
鐐	ckcf
鐑	cvfr
鐒	cffs
鐓	cydk
鐔	cmwj
鐕	cmua
鐖	cvii
鐗	canb
鐘	cytg
鐙	cnot
鐚	cmmp
鐛	cayf
鐜	ykc
鐝	cmto
鐞	csmi
鐟	cqoa
鐠	ctca
鐡	cjit
鐢	ddc
鐣	cfbq
鐤	cbul
鐥	cttr
鐦	cant
鐧	cana
鐨	clnc
鐩	cyto
鐪	cyps
鐫	cogs
鐬	cymh
鐭	chbk
鐮	citc
鐯	ctja
鐰	crrd
鐱	como
鐲	cwli
鐳	cmbw
鐴	csrj
鐵	cjig
鐶	cwlv
鐷	ctpd
鐸	cwlj
鐹	cybb
鐺	cfbw
鐻	cypo
鐼	cjtc
鐽	cygq
鐾	sjc
鐿	cytp
鑀	cbbe
鑁	cuce
鑂	chgf
鑃	csmg
鑄	cgni
鑅	cffd
鑆	ctgi
鑇	cyx
鑈	cmfb
鑉	ctgt
鑊	ctoe
鑋	jmc
鑌	cjmc
鑍	bcc
鑎	cs'lc
鑏	cjpn
鑐	cmbb
鑑	csit
鑒	swc
鑓	cylr
鑔	cjbf
鑕	chlc
鑖	ctwi
鑗	chhe
鑘	cwww
鑙	chua
鑚	cqoc
鑛	citc
鑜	cfbc
鑝	ctyj
鑞	cvvv
鑟	cgwc
鑠	cvid
鑡	cymu
鑢	cypp
鑣	cipf
鑤	cate
鑥	cnwa
鑦	csec
鑧	cjti
鑨	cybp
鑩	cmgr
鑪	cypt
鑫	ccc
鑬	csiu
鑭	canw
鑮	ctei
鑯	coim
鑰	comb
鑱	cnri
鑲	cyrv
鑳	cjto
鑴	cuob
鑵	ctrg
鑶	ctis
鑷	csjj
鑸	cwwg
鑹	cjcv
鑺	cbug
鑻	cddq
鑼	cwlg
鑽	chuc
鑾	vfc
鑿	tec
钀	cybk
钁	cbue
钂	cfbf
钃	csei
钄	ctaw
钆	opu
钇	opn
针	opj
钉	opmn
钊	opln
钋	opy
钌	opnn
钍	opg
钎	ophj
钏	oplll
钐	ophhh
钑	opnhe
钒	ophn'i
钓	oppi
钔	oplis
钕	opv
钖	opnsh
钗	ope'i
钘	opmt
钙	opmys
钚	opmf
钛	opki
钜	opss
钝	oppu
钞	opfh
钟	opl
钠	opob
钡	opbo
钢	opb'k
钣	ophe
钤	opoin
钥	opb
钦	opno
钧	oppim
钨	oppvm
钩	oppi
钪	opyhn
钫	opyhs
钬	opf
钭	opyj
钮	opng
钯	opau
钰	opmgi
钱	opij
钲	opmym
钳	opt'm
钴	opjr
钵	opdm
钶	opmnr
钷	ops'r
钸	opklb
钹	opike
钺	opiv
钻	opyr
钼	opbu
钽	opam
钾	opwl
钿	opw
铀	oplw
铁	ophqo
铂	opha
铃	opoii
铄	ophvd
铅	ophnr
铆	ophhl
铇	oppru
铈	opylb
铉	opyvi
铊	opjp
铋	opph
铌	opsp
铍	opdhe
铎	opeq
铏	opmtn
铐	opjks
铑	opjkp
铒	opsj
铓	optyv
铔	opmtc
铕	opkb
铖	opihs
铗	opkt
铘	opmhl
铙	opjpu
铚	opmig
铛	opfsm
铛	opfs'm
铜	opb'mr
铝	oprr
铞	oprlb
铟	opw'k
铠	opusu
铡	opbon
铢	ophjd
铣	ophgu
铤	opnkg
铥	ophgi
铦	ophjr
铧	opopj
铨	opomg
铩	opkd
铪	opomr
铫	oplmo
铬	opher
铭	opnir
铮	opnsd
铯	opnau
铰	opyck
铱	opyhv
铲	opyth
铳	opyiu
铴	openh
铵	opjv
银	opav
铷	opvr
铸	opqki
铹	optbs
铺	opijb
铻	opmmr
铼	opdt
铽	opipp
链	opykq
铿	opleg
销	opfb
锁	opfbo
锂	opwg
锃	oprmg
锄	opbms
锅	oprob
锆	ophgr
锇	ophqi
锈	ophds
锉	opoog
锊	opbdi
锋	ophej
锌	opytj
锍	opyiu
锎	oplst
锏	oplsa
锐	opcru
锑	opcnh
锒	opiav
锓	opsme
锔	opss'r
锕	opnlr
锖	opqmb
锗	opjka
锘	optkr
错	opta
锚	optw
锛	opkjt
锜	opkmr
锝	opami
锞	opwd
锟	opapp
锠	opaa
锡	opaph
锢	opw'jr
锣	opwln
锤	ophjm
锥	opog
锦	ophab
锧	ophjo
锨	ophlo
锩	opfqu
锪	opphp
锫	opytr
锬	opff
锭	opjmo
键	opnkq
锯	opsjr
锰	opndt
锱	opvvw
锲	opqhk
锳	optlk
锴	opppa
锵	oplmi
锶	opwp
锷	oprrs
锸	ophjx
锹	ophdf
锺	ophjg
锻	ophje
锼	ophxe
锽	ophag
锾	opbme
锿	opyrv
镀	opite
镁	optgk
镂	opfdv
镃	optvi
镄	oplno
镅	opahu
镆	optak
镇	opjbc
镈	opibi
镉	opmrb
镊	opsje
镋	opfbu
镌	opogs
镍	ophud
镎	oporq
镏	ophhw
镐	opyrb
镑	opybs
镒	optct
镓	opjmo
镔	opjoc
镕	opjcr
镖	opmwf
镗	opfbg
镘	opawe
镙	opwvf
镚	opubb
镛	opilb
镜	opytu
镝	opycb
镞	opysk
镟	opyso
镠	opsmh
镡	opmwj
镢	opmto
镣	opkcf
镤	optco
镥	opnwa
镦	opydk
镧	oplsw
镨	optca
镩	opjcl
镪	opnri
镫	opnot
镬	optoe
镭	opmbw
镮	opwlv
镯	opwli
镰	opitc
镱	opytp
镲	opjbf
镳	opipf
镴	opvvv
镵	opnri
镶	opyrv
長	smv
镹	sino
镺	sihk
镻	sihqo
镼	sisuu
镽	sikcf
镾	simfb
长	po
門	an
閁	anh
閂	anm
閃	ano
閄	ano
閅	anmn
閆	anmmm
閇	anmy
閈	anmj
閉	andh
閊	anu
開	anmt
閌	anyhn
閍	anyhs
閎	anki
閏	anmg
閐	anhqu
閑	and
閒	anb
間	ana
閔	anyk
閕	anmvh
閖	ane
閗	anyj
閘	anwl
閙	anylb
閚	anyt
閛	anmfj
閜	anmnr
閝	anoii
閞	anit
閟	anph
閠	anmgi
閡	anyvo
関	antk
閣	anher
閤	anomr
閥	anoi
閦	anooo
閧	antc
閨	angg
閩	anlmi
閪	anmcw
閫	anw'd
閬	aniav
閭	anrhr
閮	annkg
閯	anefh
閰	anhx
閱	ancru
閲	ancru
閳	anjwj
閴	anbuc
閵	anog
閶	anaa
閷	kcano
閸	anmlm
閹	anklu
閺	anayk
閻	annhx
閼	anysy
閽	anhpa
閾	anirm
閿	anbbe
闀	antcu
闁	anan
闂	anfqu
闃	anbuk
闄	anmwv
闅	anbue
闆	anrrr
闇	anyta
闈	andmq
闉	anmwg
闊	anehr
闋	annok
闌	andw'f
闍	anjka
闎	anhae
闏	anhn'i
闐	anjbc
闑	anhud
闒	anasm
闓	anumt
闔	angit
闕	antuo
闖	ansqf
闗	anvif
闘	anmti
闙	anhrk
闚	anqou
闛	anfbg
關	anvit
闝	anbck
闞	anmjk
闟	anorm
闠	anlmc
闡	anrrj
闢	ansrj
闣	anfbw
闤	anwlv
闥	anygq
闦	antwt
闧	anygv
门	lis
闩	lsm
闪	lso
闫	lsmmm
闬	lsmj
闭	lsdh
问	lsr
闯	lsnvm
闰	lsmg
闱	lsqs
闲	lsd
闳	lski
间	lsa
闵	lsyk
闶	lsyhn
闷	lsp
闸	lswl
闹	lsylb
闺	lsgg
闻	lssj
闼	lsyk
闽	lslmi
闾	lsrr
闿	lsusu
阀	lsoi
阁	lsher
阂	lsyvo
阃	lsw'd
阄	lsnwu
阅	lscru
阆	lsiav
阇	lsjka
阈	lsirm
阉	lsklu
阊	lsaa
阋	lshxu
阌	lsbbe
阍	lshpa
阎	lsnhx
阏	lsysy
阐	lscwj
阑	lsdw'f
阒	lsbuk
阓	lslmo
阔	lsehr
阕	lsnok
阖	lsgit
阗	lsjbc
阘	lsasm
阙	lstuo
阚	lsnjk
阛	lswlv
阜	hrj
阞	nlks
队	nlo
阠	nlnj
阡	nlhj
阢	nlmu
阣	nlon
阤	nlpd
阥	nle
阦	nlf
阧	nlyj
阨	nlmsu
阩	nlht
阪	nlhe
阫	nlmf
阬	nlyhn
阭	nlihu
阮	nlmmu
阯	nlylm
阰	nlpp
阱	nltt
防	nlyhs
阳	nla
阴	nlb
阵	nlkq
阶	nloll
阷	nlmym
阸	nlhsn
阹	nlgi
阺	nlhpm
阻	nlbm
阼	nlos
阽	nlyr
阾	nloii
阿	nlmnr
陀	nljp
陁	nlopd
陂	nldhe
陃	nlmob
附	nlodi
际	nlmmf
陆	nlqu
陇	nlikp
陈	nlkd
陉	nlnom
陊	nlnin
陋	nlmbv
陌	nlma
降	nlheq
陎	nlhjd
陏	nlkb
限	nlav
陑	nlmb'l
陒	nlnmu
陓	nlkms
陔	nlyvo
陕	nlkt
陖	nlice
陗	nlfb
陘	nlmvm
陙	nlmmv
陚	nlmpm
陛	nlppg
陜	nlkoo
陝	nlkoo
陞	nlhtg
陟	nlylh
陠	nlijb
陡	nlgyo
院	nljmu
陣	nljwj
除	nlomd
陥	nlnla
陦	nlqki
陧	nlag
陨	nlrbo
险	nlomm
陪	nlytr
陫	nllmy
陬	nlsje
陭	nlkmr
陮	nlog
陯	nlomb
陰	nloii
陱	nlpfd
陲	nlhjm
陳	nldw
陴	nlhwj
陵	nlgce
陶	nlpou
陷	nlnhx
陸	nlgcg
陹	nlhta
険	nlomo
陻	nlmwg
陼	nljka
陽	nlamh
陾	nlmbk
陿	nls'ko
隀	nlhjg
隁	nls'av
隂	nlosi
隃	nlomn
隄	nlamo
隅	nlwlb
隆	nlhem
隇	nlihv
隈	nlwmv
隉	nlhxg
隊	nltpo
隋	nlkmb
隌	nlyta
隍	nlhag
階	nlppa
随	nlykb
隐	nlnsp
隑	nlumt
隒	nltxc
隓	nlkmm
隔	nlmrb
隕	nlrbc
隖	nlhrf
隗	nlhui
隘	nltct
隙	nlfaf
隙	nlfhf
隚	nlfbg
際	nlbof
障	nlytj
隝	nlhaf
隞	nlgsk
隟	nlvvd
隠	nlbsp
隡	nlyhm
隢	nlggu
隣	nlfdq
隤	nllmc
隥	nlnot
隦	nlsrj
隧	nlyto
隨	nlykb
隩	nlhbk
險	nlomo
隫	nljtc
隬	nlmfb
隭	nlmbb
隮	nlyx
隯	nlgni
隰	nlavf
隱	nlbmp
隲	nlfhf
隳	nbop
隴	nlybp
隵	nlyti
隶	le
隷	gfle
隸	dfle
隹	og
隻	oge
隼	ogj
隽	ognhs
难	eog
隿	ipog
雀	fog
雁	moog
雂	onog
雃	mtog
雄	kiog
雅	mhog
集	ogd
雇	hsog
雇	isog
雈	tog
雉	okog
雊	prog
雋	oglms
雌	ympog
雍	yvhg
雎	bmog
雏	nsog
雐	ypog
雑	kdog
雒	hrog
雓	odog
雔	ogog
雕	brog
雖	riog
雗	jjoog
雘	bytoe
雙	oge
雚	trrg
雛	puog
雜	ydog
雝	vuog
雞	bkog
雟	uogb
雠	ogivg
雡	shog
離	ybog
難	toog
雤	hbog
雥	ogogg
雦	ogogg
雧	ogogd
雨	mlb'y
雩	mbmms
雪	mbsm
雪	mbs'm
雫	mbmy
雬	mbd
雭	mbnhe
雮	mbhqu
雯	mbyk
雰	mbcsh
雱	mbyhs
雲	mbmmi
雳	mbmks
雴	mbyt
雵	mblbk
零	mboii
雷	mbw
雸	mbtm
雹	mbpru
雺	mbnih
電	mbwu
雼	mbmr
雽	mbhfd
雾	mbhes
雿	mblmo
需	mbmb'l
霁	mbykl
霂	mbed
霃	mbelu
霄	mbfb
霅	mbymr
霆	mbnkg
震	mbmmv
霈	mbejb
霉	mbowy
霊	mbmmc
霋	mbjlv
霌	mbb'gr
霍	mbog
霎	mbytv
霏	mblmy
霐	mbeni
霑	mbeyr
霒	mioin
霓	mbhxu
霔	mbeyg
霕	mipu
霖	mbdd
霗	mbeoi
霘	mbeb'r
霙	mbtlk
霚	mbnhk
霛	mbnnn
霜	mbdbu
霝	mbrrr
霞	mbrse
霟	mbetc
霠	mbytn
霡	mbbie
霢	mbbhv
霣	mbrbc
霤	mbhhw
霥	mbbmo
霦	mbddh
霧	mbnhs
霨	mbsfi
霩	mbydl
霪	mbebg
霫	mbsma
霬	mbwtc
霭	mbivv
霮	mbetv
霯	mbnot
霰	mbtbk
霱	mbnhb
露	mbrmr
霳	mbnlm
霴	mile
霵	mbrji
霶	mbeys
霷	mbaah
霸	mbtjb
霹	mbsrj
霺	mbhok
霻	mbtwt
霼	miond
霽	mbyx
霾	mbbhg
霿	mbnhu
靀	mbtbo
靁	mbwww
靂	mbmhm
靃	mbogg
靄	mbyrv
靅	milnc
靆	miyle
靇	mbybp
靈	mbrro
靉	mibbe
靊	mbujt
靋	mbemm
靌	mbjmc
靍	mbogf
靎	mbchf
靏	mbogf
靐	mwmww
靑	qmb'lm
青	qmb
靓	qbbhu
靔	qbomn
靕	mmqmb
靖	ytqmb
靗	qbfmu
靘	qbnau
静	qbnsd
靚	qbbuu
靛	qbjmo
靜	qbbsd
靝	qbond
非	lmsy
靟	lyhqu
靠	hgrly
靡	iclmy
靡	idlmy
面	mw'sl
靣	mw'r
靤	mwpru
靥	mikw
靦	mwbuu
靧	mwlmc
靨	mkmw'l
革	tlj
靪	tjmn
靫	tje'i
靬	tjmj
靭	tjshi
靮	tjpi
靯	tjg
靰	tjmu
靱	tjsk
靲	tjoin
靳	tjhml
靴	tjop
靵	tjng
靶	tjau
靷	tjnl
靸	tjnhe
靹	tjob
靺	tjdj
靻	tjbm
靼	tjam
靽	tjfq
靾	tjpt
靿	tjvis
鞀	tjshr
鞁	tjdhe
鞂	tjhd
鞃	tjni
鞄	tjpru
鞅	tjlbk
鞆	tjmob
鞇	tjw'k
鞈	tjomr
鞉	tjlmo
鞊	tjgr
鞋	tjgg
鞌	jvtj
鞍	tjjv
鞎	tjav
鞏	mntlj
鞐	tjymy
鞑	tjyk
鞒	tjhkl
鞓	tjrmg
鞔	tjnau
鞕	tjmlk
鞖	tjbv
鞗	oloj
鞘	tjfb
鞙	tjrb
鞚	tjjcm
鞛	tjytr
鞜	tjea
鞝	tjfb'r
鞞	tjhwj
鞟	tjyrd
鞠	tjpfd
鞡	tjqyt
鞢	tjptd
鞣	tjnhd
鞤	gitlj
鞥	tjort
鞦	tjhdf
鞧	tjtcw
鞨	tjapv
鞩	tjfbn
鞪	nktlj
鞫	tjpyr
鞬	tjnkq
鞭	tjomk
鞮	tjamo
鞯	tjtkd
鞰	tjabt
鞱	tjbhx
鞲	tjttb
鞳	tjtor
鞴	tjthb
鞵	tjbvk
鞶	hetlj
鞷	mrbj
鞸	tjwtj
鞹	tjydl
鞺	tjfbg
鞻	tjllv
鞼	tjlmc
鞽	tjhkb
鞾	tjtmj
鞿	tjvii
韀	tjixf
韁	tjmwm
韂	tjncr
韃	tjygq
韄	tjtoe
韅	tjavf
韆	tjymu
韇	tjgwc
韈	tjtwi
韉	tjtif
韊	tjtaw
韋	dmrq
韌	dqshi
韍	dqikk
韎	dqdj
韏	fqdmq
韐	dqomr
韑	fudmq
韒	dqfb
韓	jjdmq
韔	dqsmv
韕	dqyrd
韖	dqnhd
韗	dqbjj
韘	dqptd
韙	aodmq
韚	dqtlj
韛	dqthb
韜	dqbhx
韝	dqttb
韞	dqwot
韟	dqhaj
韠	dqwtj
韡	dqtmj
韢	dqjip
韣	dqwli
韤	dqtwi
韥	dqgwc
韦	qs
韧	qsshi
韨	qsike
韩	jjqs
韪	aoqs
韫	qsabt
韬	qsbhx
韭	lsmm
韮	tlsm
韯	jilsm
韰	yelsm
韱	oilsm
韲	ysom
音	yta
韴	yamlb
韵	yapim
韶	yashr
韷	yauu
韸	yahej
韹	yahag
韺	yatlk
韻	yarbc
韼	yayhj
韽	owyta
韾	geyta
響	vlyta
頀	yatoe
頁	mbuc
頂	mnmbc
頃	pmbc
頄	knmbc
項	mmbc
順	lllc
頇	mjmbc
須	hhmbc
頉	ymmbc
頊	mgmbc
頋	mumbc
頌	cimbc
頍	jembc
頎	hlmbc
頏	ynmbc
預	nnmbc
頑	mumbc
頒	chmbc
頓	pumbc
頔	lwmbc
頕	yrmbc
頖	fqmbc
頗	dembc
領	oimbc
頙	mmmbc
頚	egmbc
頛	qdmbc
頜	ormbc
頝	ykmbc
頞	jvmbc
頟	hrmbc
頠	numbc
頡	grmbc
頢	hrmbc
頣	slmbc
頤	slmbc
頥	lslc
頦	yombc
頧	hrmbc
頨	smmbc
頩	ttmbc
頪	fdmbc
頫	lmuoc
頬	ktmbc
頭	mtmbc
頮	etmbc
頯	btmbc
頰	kombc
頱	bimbc
頲	ngmbc
頳	gcmbc
頴	pfmbc
頵	srmbc
頶	hrmbc
頷	ormbc
頸	mmmbc
頹	humbc
頺	hsmbc
頻	yhmbc
頼	dlmbc
頽	hnmbc
頾	hcymp
頿	hpmbc
顀	ogmbc
顁	jombc
顂	dombc
顃	ffmbc
顄	uembc
顅	hbmbc
顆	wdmbc
顇	yjmbc
顈	pfmbc
顉	cmbc
顊	hjmbc
顋	wpmbc
題	aombc
額	jrmbc
顎	rsmbc
顏	yhmbc
顐	bjmbc
顑	irmbc
顒	wbmbc
顓	ubmbc
顔	yhmbc
顕	acmbc
顖	hpmbc
顗	utmbc
願	mfmbc
顙	edmbc
顚	pcmbc
顛	jcmbc
顜	tbmbc
顝	bbmbc
類	fkmbc
顟	shmbc
顠	mfmbc
顡	yombc
顢	tbmbc
顣	ifmbc
顤	gumbc
顥	afmbc
顦	ofmbc
顧	hgmbc
顨	mcml
顩	oombc
顪	yhmbc
顫	ymmbc
顬	mbmbc
顭	tnmbc
顮	jcmbc
顯	afmbc
顰	ychwj
顱	ytmbc
顲	fwmbc
顳	sjmbc
顴	tgmbc
页	mbo
顶	mnmbo
顷	pmbo
顸	mjmbo
项	mmbo
顺	lllo
须	hhmbo
顼	mgmbo
顽	mumbo
顽	mvmbo
顾	mvmbo
顿	pumbo
颀	hlmbo
颁	chmbo
颂	cimbo
颃	ynmbo
预	nnmbo
颅	ysmbo
领	oimbo
颇	dembo
颈	nmmbo
颉	grmbo
颊	ktmbo
颋	ngmbo
颌	ormbo
颍	pembo
颎	pfmbo
颏	yombo
颐	slmbo
频	yhmbo
颒	etmbo
颓	hnmbo
颔	ormbo
颕	pfmbo
颖	pdmbo
颗	wdmbo
题	aombo
颙	wbmbo
颚	rsmbo
颛	ubmbo
颜	yhmbo
额	jrmbo
颞	sembo
颟	tbmbo
颠	jcmbo
颡	edmbo
颢	afmbo
颣	ffmbo
颤	ymmbo
颥	mbmbo
颦	yohwj
颧	tgmbo
風	hn'hli
颩	hnhhh
颪	myhn
颫	hnqo
颬	hnmvh
颭	hnyr
颮	hnpru
颯	ythn'i
颰	hnikk
颱	hnir
颲	hnmnn
颳	hnhjr
颴	hnono
颵	hnfb
颶	hnbmc
颷	hnff
颸	hnwp
颹	hndmq
颺	hnamh
颻	buhn'i
颼	hnhxe
颽	uthn'i
颾	hneii
颿	sfhn'i
飀	hnhhw
飁	sahn'i
飂	hnsmh
飃	hnmwf
飄	mfhn'i
飅	hnmlw
飆	ikhn'i
飇	hnikk
飈	hnfff
飉	hnkcf
飊	ffhn'i
飋	hnmgh
飌	tghn'i
飍	hnhnn
风	hn'k
飏	hnnsh
飐	hnyr
飑	hnpru
飒	ythn'k
飓	hnbmc
飔	hnwp
飕	hnhxe
飖	buhn'k
飗	hnhhw
飘	mfhn'k
飙	ikhn'k
飚	hnfff
飛	nohto
飜	hwnoo
飝	nonoo
飞	no
食	oiav
飡	imoiv
飢	oihn
飣	oimn
飤	oio
飥	oihp
飦	oimj
飧	nioiv
飨	vhoiv
飩	oipu
飪	oihg
飫	oihk
飬	fqiav
飭	oioks
飮	osno
飯	oihe
飰	oiyy
飱	mnoiv
飲	oino
飳	oiyg
飴	oiir
飵	oios
飶	oiph
飷	oibm
飸	rsoiv
飹	oihhl
飺	ypoiv
飻	oiohh
飼	oismr
飽	oipru
飾	oiolb
飿	oiuu
餀	oitk
餁	oiohg
餂	oihjr
餃	oiyck
餄	oiomr
餅	oitt
餆	oilmo
餇	oib'mr
餈	mooiv
餉	oihb'r
養	toiav
餋	fqoiv
餌	oisj
餍	mikv
餎	oiher
餏	oiyhv
餐	yeoiv
餑	oijbd
餒	oibv
餓	oihqi
餔	oiijb
餕	oiice
餖	oimrt
餗	oidl
餘	oiomd
餙	oikkb
餚	oikkb
餛	oiapp
餜	oiwd
餝	oitys
餞	oiii
餟	oieee
餠	oiytt
餡	oinhx
餢	oiytr
餣	oiklu
餤	oiff
餥	lyoiv
餦	oismv
餧	oihdv
館	oijrr
餩	oicyo
餪	oimbk
餫	oibjj
餬	oijrb
餭	oihag
餮	mhoiv
餯	oivno
餰	oihon
餱	oionk
餲	oiapv
餳	oiamh
餴	oikjt
餵	oiwmv
餶	oibbb
餷	oidam
餸	oiytk
餹	oiilr
餺	oiibi
餻	oitgf
餼	oiond
餽	oihui
餾	oihhw
餿	oihxe
饀	oibhx
饁	oigit
饂	oiwot
饃	oitak
饄	oifbg
饅	oiawe
饆	oiwtj
饇	ois'rr
饈	oitqg
饉	oitlm
饊	oitbk
饋	oilmc
饌	oiruc
饍	oittr
饎	oigrr
饏	mkoiv
饐	oigbt
饑	oivii
饒	oiggu
饓	oifbd
饔	yvgv
饕	rnoiv
饕	ruoiv
饖	oiymh
饗	vloiv
饘	oiywm
饙	oijtc
饚	oitgt
饛	oitbo
饜	mkoiv
饝	oiicr
饞	oinri
饟	oiyrv
饠	oiwlg
饡	oihuc
饢	oijbv
饤	nvmn
饥	nvhn
饦	nvhp
饧	nvnsh
饨	nvpu
饩	nvomn
饪	nvhg
饫	nvhk
饬	nvoks
饭	nvhe
饮	nvno
饯	nvij
饰	nvolb
饱	nvpru
饲	nvsmr
饳	nvuu
饴	nvir
饵	nvsj
饶	nvjpu
饷	nvhb'r
饸	nvomr
饹	nvher
饺	nvyck
饻	nvyhv
饼	nvtt
饽	nvjbd
饾	nvmrt
饿	nvhqi
馀	nvomd
馁	nvbv
馂	nvice
馃	nvwd
馄	nvapp
馅	nvnhx
馆	nvjrr
馇	nvdam
馈	nvlmo
馉	nvbbb
馊	nvhxe
馋	nvnuy
馌	nvgit
馍	nvtak
馎	nvibi
馏	nvhhw
馐	nvtqg
馑	nvtlm
馒	nvawe
馓	nvtbk
馔	nvruc
馕	nvjbv
首	thbu
馗	knthu
馘	tuirm
香	hda
馚	hacsh
馛	haike
馛	haikk
馜	hasp
馝	haph
馞	hajbd
馟	habnd
馠	haoir
馡	halmy
馢	haii
馣	haklu
馤	haapv
馥	haoae
馦	hatxc
馧	haabt
馧	hawot
馨	gehda
馩	hajtc
馪	hajmc
馫	hahaa
馬	sqsf
馭	sfe
馮	imsqf
馯	sfmj
馰	sfpi
馱	sfk
馲	sfhp
馳	sfpd
馴	sflll
馵	sft
馶	sfje
馷	sfjb
馸	sfhml
馹	sfa
馺	sfnhe
馻	sfihu
馼	sfyk
馽	sfl
馾	sflbu
馿	sfhs
駀	sfiku
駁	sfkk
駂	pjsqf
駃	sfdk
駄	sfki
駅	sfso
駇	sfok
駈	sfom
駉	sfb'r
駊	sfdhe
駋	sfshr
駌	nusqf
駍	sfmfj
駎	sflw
駏	sfss
駐	sfyg
駑	vesqf
駒	sfpr
駓	sfmfm
駔	sfbm
駕	krsqf
駖	sfoii
駗	sfohh
駘	sfir
駙	sfodi
駚	sflbk
駛	sflk
駜	sfph
駝	sfjp
駞	sfopd
駟	sfw'c
駠	sfhhl
駡	rrsqf
駢	sftt
駣	sflmo
駤	sfmig
駥	sfij
駦	fqsqf
駧	sfb'mr
駨	sfpa
駩	sfomg
駪	sfhgu
駫	sffmu
駬	sfsj
駭	sfyvo
駮	sfyck
駯	sfhjd
駰	sfw'k
駱	sfher
駲	sfill
駳	sfnkm
駴	sfit
駵	sfmls
駶	sfss'r
駷	sfdl
駸	sfsme
駹	sfiuh
駺	sfiav
駻	sfamj
駼	sfomd
駽	sfrb
駾	sfcru
駿	sfice
騀	sfhqi
騁	sflws
騂	sfytj
騃	sfiok
騄	sfvne
騅	sfog
騆	sfb'gr
騇	sfomr
騈	sfytt
騉	sfapp
騊	sfpou
騋	sfdoo
騌	sfjmf
騍	sfwd
騎	sfkmr
騏	sftmc
騐	sfoip
騑	sflmy
騒	sfeli
験	sfomo
騔	sfapv
騕	sfmwv
騖	nksqf
騗	hbsqf
騘	sfpkp
騙	sfhsb
騚	sftbn
騛	sfnoo
騜	sfhag
騝	sfnkq
騞	sfqjr
騟	sfomn
騠	sfamo
騡	sfhae
騢	sfrse
騣	sfuce
騤	sfnok
騥	sfnhd
騦	sfwp
騧	sfbb'r
騨	sffwj
騩	sfhui
騪	sfhxe
騫	jtcf
騬	sfhdp
騭	nhsqf
騮	sfhhw
騯	sfybs
騰	bfqf
騱	sfbvk
騲	sftaj
騳	sfsqf
騴	sfajv
騵	sfmhf
騶	sfpuu
騷	sfeii
騸	sfhsm
騹	sftlm
騺	gisqf
騻	sfkkk
騼	sfixp
騽	sfsma
騾	sfwvf
騿	sfytj
驀	takf
驁	gksqf
驂	sfiih
驃	sfmwf
驄	sfhwp
驅	sfs'rr
驆	sfwtj
驇	gisqf
驈	sfnhb
驉	sfypm
驊	sftmj
驋	sfnoe
驌	sflx
驍	sfggu
驎	sffdq
驏	sfsnd
驐	sfydk
驑	sfmlw
驒	sfrrj
驓	sfcwa
驔	sfmwj
驕	sfhkb
驖	sfjig
驗	sfomo
驘	ynsqf
驙	sfywm
驚	tksqf
驛	sfwlj
驜	sftcd
驝	sfgbd
驞	sfjmc
驟	sfseo
驠	sftlf
驡	ypsqf
驢	sfypt
驣	sffqf
驤	sfyrv
驥	sflpc
驦	sfmbu
驧	sftjd
驨	sfuob
驩	sftrg
驪	sfmmp
驫	sfsff
马	nvsm
驭	nme
驮	nmk
驯	nmlll
驰	nmpd
驱	nms'k
驲	nma
驳	nmkk
驴	nmis
驵	nmbm
驶	nmlk
驷	nmw'c
驸	nmodi
驹	nmpr
驺	nmnsm
驺	nmns'm
驻	nmyg
驼	nmjp
驽	venvm
驾	krnvm
驿	nmeq
骀	nmir
骁	nmjpu
骂	rrnvm
骃	nmw'k
骄	nmhkl
骅	nmopj
骆	nmher
骇	nmyvo
骈	nmtt
骉	nmnmm
骊	nmmbb
骋	nmlws
验	nmomm
骍	nmytj
骎	nmsme
骏	nmice
骐	nmtmc
骑	nmkmr
骒	nmwd
骓	nmog
骔	nmjmf
骕	nmlll
骖	nmikh
骗	nmisb
骘	nhnvm
骙	nmnok
骚	nmeii
骛	nknvm
骜	qknvm
骝	nmhhw
骞	jtcm
骟	nmism
骠	nmmwf
骡	nmwvf
骢	nmhwp
骣	nmsnd
骤	nmseo
骥	nmlpc
骦	nmmbu
骧	nmyrv
骨	bbb
骩	bbkn
骪	bbhn'i
骫	bbkni
骬	bbmd
骭	bbmj
骮	bbip
骯	bbyhn
骰	bbhne
骱	bboll
骲	bbpru
骳	bbdhe
骴	bbymp
骵	bbdm
骶	bbhvi
骷	bbjr
骸	bbyvo
骹	bbyck
骺	bbhmr
骻	bbkms
骼	bbher
骽	bbbv
骾	bbmlk
骿	bbtt
髀	bbhwj
髁	bbwd
髂	bbjhr
髃	bbwlb
髄	bbykb
髅	bbfdv
髆	bbibi
髇	bbyrb
髈	bbybs
髉	bbobg
髊	bbtqm
髋	bbjtu
髌	bbjoc
髍	bbijc
髎	bbsmh
髏	bbllv
髐	bbggu
髑	bbwli
髒	bbtmt
髓	bbykb
體	bbtwt
髕	bbjmc
髖	bbjti
髗	bbypt
高	yrb'r
髙	yslb
髚	ybyhn
髛	ybskn
髜	ybaht
髝	ybffs
髞	ybrrd
髟	sihhh
髠	shhn
髡	shmu
髢	shpd
髣	shyhs
髤	shd
髥	shbmm
髦	shhqu
髧	shlbu
髨	shmmu
髩	shmls
髪	shke
髫	shshr
髬	shmfm
髭	shymp
髮	shikk
髯	shgb
髰	shpt
髱	shpru
髲	shdhe
髳	shnih
髴	shlln
髵	shmb'l
髶	shsj
髷	shtw
髸	shtc
髹	shod
髺	shhjr
髻	shgr
髼	shhej
髽	shoog
髾	shfb
髿	shefh
鬀	shcnh
鬁	shhdn
鬂	shomc
鬃	shjmf
鬄	shaph
鬅	shbb
鬆	shdci
鬇	shbsd
鬈	shfqu
鬉	shuce
鬊	shqka
鬋	shtbn
鬌	shkmb
鬍	shjrb
鬎	shdbn
鬏	shhdf
鬐	shjpa
鬑	shtxc
鬒	shjbc
鬓	shjoc
鬔	shyhj
鬕	shtak
鬖	shiih
鬗	shtlb
鬘	shawe
鬙	shcwa
鬚	shhhc
鬛	shwkv
鬜	shanb
鬝	shana
鬞	shtwv
鬟	shwlv
鬠	shoma
鬡	shjpn
鬢	shjmc
鬣	shvvv
鬤	shyrv
鬥	ln
鬦	lnyj
鬧	lnylb
鬨	lntc
鬩	lnhxu
鬪	lnmti
鬫	lnmjk
鬬	lnbml
鬭	lnrml
鬮	lnnxu
鬯	uip
鬰	ddbuh
鬱	ddbuh
鬲	mrb'l
鬳	ypmrb
鬴	mbijb
鬵	mumrb
鬶	qumrb
鬷	mbuce
鬸	mbhhw
鬹	qumrb
鬺	mboah
鬻	nnmrb
鬼	hui
鬽	hihhh
鬾	hije
鬿	hihml
魀	hioll
魁	hiyj
魂	mihui
魃	hiike
魃	hiikk
魄	hahui
魅	hijd
魆	hiiv
魇	miki
魈	hifb
魉	himob
魊	hiirm
魋	hiog
魌	hitmc
魍	hib'tv
魎	himlb
魏	hvhui
魐	hitxc
魑	hiyub
魒	himwf
魓	hiwtj
魔	ichui
魔	idhui
魕	hivii
魖	hiypm
魗	gihui
魘	mkhui
魙	elhui
魚	nwf
魛	nfsh
魜	nfo
魝	nfln
魞	nfo
魟	nfm
魠	nfhp
魡	nfpi
魢	nfsu
魣	nfnin
魤	nfop
魥	nfnhe
魦	nffh
魧	nfyhn
魨	nfpu
魩	nfphh
魪	nfoll
魫	nflbu
魬	nfhe
魭	nfmmu
魮	nfpp
魯	nwfa
魰	nfyk
魱	nfmvm
魲	nfhs
魳	nfmlb
魴	nfyhs
魵	nfcsh
魶	nfob
魷	nfiku
魸	nflll
魹	nfhqu
魺	nfmnr
魻	nfwl
魼	nfgi
魽	nft'm
魾	nfmfm
魿	nfoii
鮀	nfjp
鮁	nfikk
鮂	nfw'o
鮃	nfmfj
鮄	nflln
鮅	nfph
鮆	ypnwf
鮇	nfjd
鮈	nfpr
鮉	nfshr
鮊	nfha
鮋	nflw
鮌	nfyvi
鮍	nfdhe
鮎	nfyr
鮏	nfhqm
鮐	nfir
鮑	nfpru
鮒	nfodi
鮓	nfos
鮔	nfss
鮕	nfjr
鮖	nfmr
鮗	nfhey
鮘	nfoip
鮙	nfsmm
鮚	nfgr
鮛	nfymf
鮜	nfhmr
鮝	fqnwf
鮞	nfmb'l
鮟	nfjv
鮠	nfnmu
鮡	nflmo
鮢	nfhjd
鮣	nfhpl
鮤	mnnwf
鮥	nfher
鮦	nfb'mr
鮧	nfkn
鮨	nfpa
鮩	nftt
鮪	nfkb
鮫	nfyck
鮬	nfkms
鮭	nfgg
鮮	nftq
鮯	nfomr
鮰	nfw'r
鮱	nfjkp
鮲	nfoik
鮳	nfjks
鮴	nfod
鮵	nfcru
鮶	nfskr
鮷	nfcnh
鮸	nfnau
鮹	nffb
鮺	tqnwf
鮻	nfice
鮼	nfsme
鮽	nfomd
鮾	nfbv
鮿	nfsju
鯀	nfhvf
鯁	nfmlk
鯂	nfmcw
鯃	nfmmr
鯄	nfije
鯅	nfnkm
鯆	nfijb
鯇	nfjmu
鯈	olof
鯉	nfwg
鯊	ehnwf
鯋	nfefh
鯌	nfhgr
鯍	nfyiu
鯎	nfihs
鯏	nfhdn
鯐	nfgyo
鯑	nfkkb
鯒	nfnib
鯓	nfhxh
鯔	nfvvw
鯕	nftmc
鯖	nfqmb
鯗	tonwf
鯘	nfhdv
鯙	nfyrd
鯚	nfhdd
鯛	nfb'gr
鯜	nfytv
鯝	nfw'jr
鯞	nfsmb
鯟	nfdw
鯠	nfdoo
鯡	nflmy
鯢	nfhxu
鯣	nfaph
鯤	nfapp
鯥	nfgcg
鯦	nfhor
鯧	nfaa
鯨	nfyrf
鯩	nfomb
鯪	nfgce
鯫	nfsje
鯬	hhnwf
鯭	nfndt
鯮	nfjmf
鯯	nfhbn
鯰	nfoip
鯱	nfypu
鯲	nfysy
鯳	nfihm
鯴	nfnhi
鯵	nfikh
鯶	nfbjj
鯷	nfamo
鯸	nfonk
鯹	nfahm
鯺	nfjka
鯻	nfdln
鯼	nfuce
鯽	nfail
鯾	nfomk
鯿	nfhsb
鰀	nfbme
鰁	nfhae
鰂	nfbcn
鰃	nfwmv
鰄	nfihv
鰅	nfwlb
鰆	nfqka
鰇	nfnhd
鰈	nfptd
鰉	nfhag
鰊	nfdw'f
鰋	nfs'av
鰌	nftcw
鰍	nfhdf
鰎	nfnkq
鰏	nfmrw
鰐	nfrrs
鰑	nfamh
鰒	nfoae
鰓	nfwp
鰔	nfihr
鰕	nfrse
鰖	nfkmb
鰗	nfjrb
鰘	nfjmg
鰙	nftkr
鰚	nfjmm
鰛	nfabt
鰜	nftxc
鰝	nfyrb
鰞	nfhrf
鰟	nfybs
鰠	nfeii
鰡	nfhhw
鰢	nfsqf
鰣	nfagi
鰤	nfhrb
鰥	nfwle
鰦	nftvi
鰧	bfqf
鰨	nfasm
鰩	nfbou
鰪	nfgit
鰫	nfjcr
鰬	nfypk
鰭	nfjpa
鰮	nfwot
鰯	nfnmm
鰰	nfifl
鰱	nfyjj
鰲	gknwf
鰳	nftjs
鰴	houfk
鰵	oknwf
鰶	nfbof
鰷	nfold
鰸	nfs'rr
鰹	nfseg
鰺	nfiih
鰻	nfawe
鰼	nfsma
鰽	nftwa
鰾	nfmwf
鰿	nfqmc
鱀	aunwf
鱁	nfymo
鱂	nfvmi
鱃	nftqg
鱄	nfjii
鱅	nfilb
鱆	nfytj
鱇	nfile
鱈	nfmbm
鱉	fknwf
鱊	nfnhb
鱋	nfypm
鱌	nfnao
鱍	nfnoe
鱎	nfhkb
鱏	nfmbj
鱐	nflx
鱑	nftlc
鱒	nftwi
鱓	nfrrj
鱔	nftgr
鱕	nfhdw
鱖	nfmto
鱗	nffdq
鱘	nfsmi
鱙	nfggu
鱚	nfgrr
鱛	nfcwa
鱜	nfvhl
鱝	nfjtc
鱞	nfwlv
鱟	hbnwf
鱠	nfoma
鱡	nfbcj
鱢	nfrrd
鱣	nfywm
鱤	nfirp
鱥	nfymh
鱦	nfrxu
鱧	nftwt
鱨	nffba
鱩	nfmbw
鱪	nfaja
鱫	nfbbe
鱬	nfmbb
鱭	nfyx
鱮	nfhxc
鱯	nftoe
鱰	nfwla
鱱	nfmtb
鱲	nfvvv
鱳	nfvid
鱴	nftwi
鱵	nfhir
鱶	nftov
鱷	nfmgr
鱸	nfypt
鱹	nftrg
鱺	nfmmp
鱻	nfnff
鱼	nwm
鱽	nmsh
鱾	nmsu
鱿	nmiku
鲀	nmpu
鲁	nwma
鲂	nmyhs
鲃	nmau
鲄	nmmnr
鲅	nmike
鲆	nmmfj
鲇	nmyr
鲈	nmys
鲉	nmlw
鲊	nmos
鲋	nmodi
鲌	nmha
鲍	nmpru
鲎	fbnwm
鲏	nmdhe
鲐	nmir
鲑	nmgg
鲒	nmgr
鲓	nmjks
鲔	nmkb
鲕	nmmb'l
鲖	nmb'mr
鲗	nmbon
鲘	nmhmr
鲙	nmomi
鲚	nmykl
鲛	nmyck
鲜	nmtq
鲝	tqnwm
鲞	fqnwm
鲟	nmsmi
鲠	nmmlk
鲡	nmmbb
鲢	nmykq
鲣	nmleg
鲤	nmwg
鲥	nmadi
鲦	nmhed
鲧	nmhvf
鲨	ehnwm
鲩	nmjmu
鲪	nmskr
鲫	nmail
鲬	nmnib
鲭	nmqmb
鲮	nmgce
鲯	nmtmc
鲰	nmsje
鲱	nmlmy
鲲	nmapp
鲳	nmaa
鲴	nmw'jr
鲵	nmhxu
鲶	nmoip
鲷	nmb'gr
鲸	nmyrf
鲹	nmikh
鲺	nmnhi
鲻	nmvvw
鲼	nmjto
鲽	nmptd
鲾	nmmrw
鲿	nmfbi
鳀	nmamo
鳁	nmabt
鳂	nmwmv
鳃	nmwp
鳄	nmrrs
鳅	nmhdf
鳆	nmoae
鳇	nmhag
鳈	nmhae
鳉	nmlmi
鳊	nmisb
鳋	nmeii
鳌	qknwm
鳍	nmjpa
鳎	nmasm
鳏	nmwlf
鳐	nmbou
鳑	nmybs
鳒	nmtxc
鳓	nmtjs
鳔	nmmwf
鳕	nmmbs
鳖	fknwm
鳗	nmawe
鳘	oknwm
鳙	nmilb
鳚	nmsfi
鳛	nmsma
鳜	nmmto
鳝	nmttr
鳞	nmfdq
鳟	nmtwi
鳠	nmtoe
鳡	nmirp
鳢	nmtwt
鳣	nmywm
鳤	nmhjr
鳥	hayf
鳦	hfn
鳧	hfhn
鳨	hfks
鳩	knhaf
鳪	yhaf
鳫	mhaf
鳬	hayn
鳭	shhaf
鳮	ehaf
鳯	hn'haf
鳰	ohaf
鳱	mjhaf
鳲	shaf
鳳	hn'maf
鳴	rhaf
鳵	njhaf
鳶	iphaf
鳷	jehaf
鳸	hshaf
鳹	onhaf
鳺	qohaf
鳻	chhaf
鳼	ykhaf
鳽	mthaf
鳾	mbhaf
鳿	mghaf
鴀	mfhaf
鴁	hkhaf
鴂	dkhaf
鴃	hfdk
鴄	schaf
鴅	byhaf
鴆	luhaf
鴇	pjhaf
鴈	mohf
鴉	mhhaf
鴊	mmhaf
鴋	yshaf
鴌	mkhaf
鴍	ykhaf
鴍	ykhf
鴎	skhaf
鴏	hfoip
鴐	krhaf
鴑	vehaf
鴒	oihaf
鴓	phhaf
鴔	hohaf
鴕	hfjp
鴖	rphaf
鴗	ythaf
鴘	ithaf
鴙	okhaf
鴚	hfmnr
鴛	nuhaf
鴜	yphaf
鴝	prhaf
鴞	rshaf
鴟	hmhaf
鴠	amhaf
鴡	bmhaf
鴢	viksf
鴣	jrhaf
鴤	hfhey
鴥	hfjc
鴦	lkhaf
鴧	juhaf
鴨	wlhaf
鴩	hohaf
鴪	jchaf
鴫	whaf
鴬	fbhaf
鴭	hrhaf
鴮	kshaf
鴯	mbhaf
鴰	hrhaf
鴱	tkhaf
鴲	pahaf
鴳	jvhaf
鴴	homnf
鴵	lmuof
鴶	grhaf
鴷	mnhaf
鴸	hdhaf
鴹	tqhaf
鴺	knhaf
鴻	emhf
鴼	hfher
鴽	vrhaf
鴾	iqhaf
鴿	orhaf
鵀	oghaf
鵁	ykhaf
鵂	odhf
鵃	hyhaf
鵄	mghaf
鵅	hrhaf
鵆	hohfn
鵇	oqhaf
鵈	sjhaf
鵉	ychaf
鵊	kohaf
鵋	sphaf
鵌	hfomd
鵍	juhaf
鵎	bvhaf
鵏	ibhaf
鵐	mohaf
鵑	rbhaf
鵒	crhaf
鵓	jdhaf
鵔	hfice
鵕	iehaf
鵖	hphaf
鵗	kbhaf
鵘	srhaf
鵙	bchaf
鵚	huhaf
鵛	mmhaf
鵜	chhaf
鵝	hihaf
鵞	hihaf
鵟	kghaf
鵠	hrhaf
鵡	mmhaf
鵢	hhhaf
鵣	dlhaf
鵤	nbhaf
鵥	fnhaf
鵦	hfvne
鵧	tthaf
鵨	orhaf
鵩	bsef
鵪	kuhaf
鵫	yjhaf
鵬	bbhf
鵭	chaf
鵮	nxhaf
鵯	hjhaf
鵰	brhaf
鵱	gghaf
鵲	tahaf
鵳	hbhaf
鵴	pdhaf
鵵	nihaf
鵶	mmhaf
鵷	juhaf
鵸	krhaf
鵹	hhhaf
鵺	ykhaf
鵻	hfog
鵼	jmhaf
鵽	eeeef
鵾	aphaf
鵿	hfaht
鶀	hftmc
鶁	yfhaf
鶂	huhaf
鶃	hfhxu
鶄	qbhaf
鶅	vwhaf
鶆	dohaf
鶇	dwhaf
鶈	jvhaf
鶉	ydhaf
鶊	iohaf
鶋	srhaf
鶌	suhaf
鶍	ahhaf
鶎	jfhaf
鶏	bohaf
鶐	ychaf
鶑	ffhaf
鶒	dlksf
鶓	twhaf
鶔	ndhaf
鶕	yahaf
鶖	hfhaf
鶗	aohaf
鶘	jrbhf
鶙	ybhaf
鶚	rshaf
鶛	pahaf
鶜	thhaf
鶝	mwhaf
鶞	huhaf
鶟	jkhaf
鶠	svhaf
鶡	avhaf
鶢	behaf
鶣	hbhaf
鶤	bjhaf
鶥	auhaf
鶦	jbhaf
鶧	tkhaf
鶨	vohaf
鶩	nkhaf
鶪	bkhaf
鶫	dwhaf
鶬	orhaf
鶭	vshaf
鶮	ybhaf
鶯	ffbhf
鶰	rchaf
鶱	jtcf
鶲	cmhaf
鶳	hfhrb
鶴	oghaf
鶵	puhaf
鶶	irhaf
鶷	jrhaf
鶸	nmnmf
鶹	hwhaf
鶺	fbhaf
鶻	bbhaf
鶼	tchaf
鶽	ojhaf
鶾	jjohf
鶿	tvif
鷀	tihaf
鷁	tthaf
鷂	buhaf
鷃	avhaf
鷄	bkhaf
鷅	mdhaf
鷆	pchaf
鷇	gfhne
鷈	hfhyu
鷉	huhaf
鷊	mbhaf
鷋	tdhaf
鷌	hfsqf
鷍	hdhaf
鷎	hmhaf
鷏	jchaf
鷐	avhaf
鷑	hthaf
鷒	jihaf
鷓	ifhaf
鷔	gkhaf
鷕	rghaf
鷖	sehaf
鷗	srhaf
鷘	dkhaf
鷙	gihaf
鷚	shhaf
鷛	ibhaf
鷜	lvhaf
鷝	wjhaf
鷞	kkhaf
鷟	ykhaf
鷠	nfhaf
鷡	ofhaf
鷢	mohaf
鷣	mjhaf
鷤	rjhaf
鷥	vfhaf
鷦	ofhaf
鷧	gthaf
鷨	tjhaf
鷩	fkhaf
鷪	bubhf
鷫	lxhaf
鷬	tchaf
鷭	hwhaf
鷮	hbhaf
鷯	kfhaf
鷰	tlpf
鷱	hjhaf
鷲	yuhaf
鷳	abhaf
鷴	adhaf
鷵	sahaf
鷶	wchaf
鷷	tihaf
鷸	nbhaf
鷹	iogf
鷺	rrhaf
鷻	hfydk
鷼	aahaf
鷽	hbhaf
鷾	yphaf
鷿	sjhaf
鸀	wihaf
鸁	ynhaf
鸂	ebkf
鸃	hftgi
鸄	hkhaf
鸅	wjhaf
鸆	ykhaf
鸇	ymhaf
鸈	tdhaf
鸉	dhhaf
鸊	sryjf
鸋	jnhaf
鸌	hftoe
鸍	mbhaf
鸎	bchaf
鸏	tohaf
鸐	sghaf
鸑	kkhaf
鸒	hchaf
鸓	wwhaf
鸔	hfate
鸕	ythaf
鸖	mghaf
鸗	yphaf
鸘	muhaf
鸙	obhaf
鸚	bvhaf
鸛	tghaf
鸜	bghaf
鸝	mphaf
鸞	vfhaf
鸟	pysm
鸠	knpym
鸡	epym
鸢	ippym
鸣	rpym
鸤	spym
鸥	skpym
鸦	mhpym
鸧	oupym
鸨	pjpym
鸩	lupym
鸪	jrpym
鸫	kdpym
鸬	yspym
鸭	wlpym
鸮	rspym
鸯	lkpym
鸰	oipym
鸱	hipym
鸲	prpym
鸳	nupym
鸴	fbpym
鸵	pmjp
鸶	vvmpm
鸷	qipym
鸸	mbpym
鸹	hrpym
鸺	odpm
鸻	homnm
鸼	hypym
鸽	orpym
鸾	ycpym
鸿	empm
鹀	mopym
鹁	jdpym
鹂	mbpym
鹃	rbpym
鹄	hrpym
鹅	hipym
鹆	crpym
鹇	ldpym
鹈	chpym
鹉	mmpym
鹊	tapym
鹋	twpym
鹌	kupym
鹍	appym
鹎	hjpym
鹏	bbpm
鹐	nxpym
鹑	ydpym
鹒	iopym
鹓	jupym
鹔	llpym
鹕	jrbpm
鹖	avpym
鹗	rspym
鹘	bbpym
鹙	hfpym
鹚	tipym
鹛	aupym
鹜	nkpym
鹝	mbpym
鹞	bupym
鹟	cmpym
鹠	hwpym
鹡	fbpym
鹢	ttpym
鹣	tcpym
鹤	ogpym
鹥	sepym
鹦	bvpym
鹧	ifpym
鹨	shpym
鹩	kfpym
鹪	ofpym
鹫	yupym
鹬	nbpym
鹭	rrpym
鹮	wvpym
鹯	ympym
鹰	iogm
鹱	pmtoe
鹲	topym
鹳	tgpym
鹴	mupym
鹵	yw'ii
鹶	ywoin
鹷	ywoii
鹸	ywomo
鹹	ywihr
鹺	ywtqm
鹻	ywtxc
鹼	ywomo
鹽	swbt
鹾	ywtqm
鹿	ixp
麀	ipp
麁	nixp
麂	iphn
麃	ipf
麄	cshp
麅	ippru
麆	ipbm
麇	iphd
麈	ipyg
麉	mjixp
麊	fdixp
麋	ipfd
麌	iprvk
麍	ipyiu
麎	ipmmv
麏	ipskr
麐	ipykr
麑	iphxu
麒	iptmc
麓	ddixp
麔	iphor
麕	ipw'hd
麖	ipyrf
麗	mmbbp
麘	iphda
麙	ipihr
麚	iprse
麛	ipnsj
麜	ipmwd
麝	iphhi
麞	ipytj
麟	ipfdq
麠	ipmwm
麡	ipyx
麢	ipmbr
麣	iprrk
麤	ipipp
麥	joni
麦	qme
麧	jeon
麨	jefh
麩	jeqo
麪	jemls
麫	jemys
麬	jedhe
麭	jepru
麮	jegi
麯	jetw
麰	jeihq
麱	jeijb
麲	jebuu
麳	jedoo
麴	jepfd
麴	jnpfd
麵	jemw'l
麶	jeyub
麷	jeujt
麸	qeqo
麹	qepfd
麺	qemw'l
麻	idd
麻	ijcc
麼	icvi
麽	ichi
麾	ichqu
麾	idhqu
麿	icrhr
黀	icsje
黁	ichda
黂	icjtc
黃	tmlc
黄	tlwc
黅	tcoin
黆	tclbu
黇	tcyr
黈	tcyg
黉	fbtlc
黊	tcgg
黋	futlc
黌	hbtlc
黍	hdoe
黎	hhoe
黏	heyr
黐	heyub
黑	wgf
黒	wgf
黓	wfip
黔	wfoin
黕	wflbu
黖	wfmvu
黗	wfpu
默	wfik
黙	wkf
黚	wftm
黛	opwgf
黜	wfuu
黝	wfvis
點	wfyr
黟	wfnin
黠	wfgr
黡	mikf
黢	wfice
黣	wfowy
黤	wfklu
黥	wfyrf
黦	wfjnu
黧	hhwgf
黨	fbrwf
黩	wfjnk
黪	wfikh
黫	wfmwg
黬	wfihr
黭	wfort
黮	wftmv
黯	wfyta
黰	wfjbc
黱	bfqf
黲	wfiih
黳	sewgf
黴	houfk
黵	wfncr
黶	mkwgf
黷	wfgwc
黸	wfypt
黹	tcfb
黺	tbcsh
黻	tbike
黻	tbikk
黼	tbijb
黽	rxu
黾	rlwu
黿	mmuu
鼀	gcrxu
鼁	girxu
鼂	amru
鼃	ggrxu
鼄	hdrxu
鼅	orrxu
鼆	bcrxu
鼇	gkrxu
鼈	fkrxu
鼉	rrwmu
鼊	sjrxu
鼋	mmuu
鼌	amru
鼍	rrwmu
鼎	buvml
鼎	buvmn
鼏	bbul
鼐	nsbul
鼑	yuvmn
鼒	dhbul
鼓	gtje
鼔	gtye
鼕	gehey
鼖	jtge
鼗	logte
鼘	gelxl
鼙	gehwj
鼚	gesmv
鼛	gehor
鼜	geeii
鼝	elgte
鼞	gefbg
鼟	genot
鼠	hxvyv
鼡	fhnq
鼢	hvcsh
鼣	hvik
鼤	hvyk
鼥	hvikk
鼦	hvshr
鼧	hvjp
鼨	hvhey
鼩	hvpr
鼪	hvhqm
鼫	hvmr
鼬	hvlw
鼭	hvgdi
鼮	hvnkg
鼯	hvmmr
鼰	hvbuc
鼱	hvqmb
鼲	hvbjj
鼳	hvbuk
鼴	hvs'av
鼵	hvjck
鼶	hvhyu
鼷	hvbvk
鼸	hvtxc
鼹	hvajv
鼺	hvwww
鼻	huwml
鼼	hlvl
鼽	hlkn
鼾	hlmj
鼿	hlmu
齀	hlmvn
齁	hlpr
齂	hlle
齃	hlapv
齄	hldam
齅	hlhuk
齆	hlvvu
齇	hlypm
齈	hltwv
齉	hljbv
齊	yx
齋	yxf
齌	yxf
齍	yxbt
齎	yxbuc
齏	yxlsm
齐	ykll
齑	yklll
齒	ymu'oo
齓	yuu
齔	yup
齕	yuon
齖	yumvh
齗	yuhml
齘	yuoll
齙	yupru
齚	yuos
齛	yupt
齜	yuymp
齝	yuir
齞	yurc
齟	yubm
齠	yushr
齡	yuoii
齢	yuoii
齣	yupr
齤	fqymu
齥	yulwp
齦	yuav
齧	qhymu
齨	yuhx
齩	yuyck
齪	yuryo
齫	yuw'd
齬	yummr
齭	yuhsl
齮	yukmr
齯	yuhxu
齰	yuta
齱	yusje
齲	yuhlb
齳	yubjj
齴	yuyhh
齴	yuykh
齵	yuwlb
齶	yurrs
齷	yusmg
齸	yutct
齹	tmymu
齺	yupuu
齻	yujbc
齼	yuddo
齽	yuddf
齾	ykymu
齿	ymu'o
龀	yup
龁	yuon
龂	yuhml
龃	yubm
龄	yuoii
龅	yupru
龆	yushr
龇	yuymp
龈	yuav
龉	yummr
龊	yuryo
龋	yuhlb
龌	yusmg
龍	ybysp
龎	mybp
龏	ypt
龐	iybp
龑	ypmk
龒	ypmmf
龓	kbybp
龔	yptc
龕	orybp
龖	ypybp
龗	mbrrp
龘	ypybp
龙	ikp
龚	iptc
龛	orikp
龜	nxu
龝	hdnxu
龞	fknxu
龟	nwu
龠	omrb
龡	obno
龢	obhd
龣	obvne
龤	obppa
龥	obmbc
郎	ivnl
兀	mu
嗀	grhne
﨎	yge
﨏	gccr
﨑	uytr
﨓	dtoi
﨔	dfcq
﨟	tbav
蘒	thdu
﨡	lihqm
﨣	goyj
﨤	ynhe
﨧	cjkd
﨨	cgtj
﨩	nlhau
